a	a
abc	aa b ee c ee
aboridžinců	a b o r i d zh i n c uu
aby	a b i
adresu	a d r e s u
africe	a f r i c e
agresivněji	a g r e s i v nj e j i
akce	a k c e
aktivitu	a k t i v i t u
aktivity	a k t i v i t i
ale	a l e
alespoň	a l e s p o nj
alex	a l e k s
alkohol	a l k o h o l
amandu	a m a n d u
ambasády	a m b a s aa d i
americký	a m e r i c k ii
amerických	a m e r i c k ii x
američance	a m e r i ch a n c e
američanka	a m e r i ch a ng k a
američanku	a m e r i ch a ng k u
analytik	a n a l i t i k
andrej	a n d r e j
andreje	a n d r e j e
andrejem	a n d r e j e m
andreji	a n d r e j i
anebo	a n e b o
anektovaného	a n e k t o v a n ee h o
angažovala	a ng g a zh o v a l a
angličtinou	a ng g l i ch tj i n ow
ani	a nj i
anisimov	a n i z i m o f
anketa	a ng k e t a
ano	a n o
antarktidu	a n t a r k tj i d u
antonína	a n t o nj ii n a
areně	a r e nj e
argumentuje	a r g u m e n t u j e
aromatický	a r o m a t i c k ii
arény	a r ee n i
aréně	a r ee nj e
ashleigh	e sh l aa j
asi	a s i
asie	a z i j e
asijský	a s i j s k ii
atmosféra	a t m o s f ee r a
audio	aw d i j o
australani	aw s t r a l a nj i
australanka	aw s t r a l a ng k a
australankou	aw s t r a l a ng k ow
australanku	aw s t r a l a ng k u
australany	aw s t r a l a n i
australanů	aw s t r a l a n uu
australian	aw s t r a l i j a n
australská	aw s t r a l s k aa
australské	aw s t r a l s k ee
australského	aw s t r a l s k ee h o
australském	aw s t r a l s k ee m
australský	aw s t r a l s k ii
australských	aw s t r a l s k ii x
australským	aw s t r a l s k ii m
australskými	aw s t r a l s k ii m i
australští	aw s t r a l sh tj ii
austrálie	aw s t r aa l i j e
austrálii	aw s t r aa l i j i
austrálií	aw s t r aa l i j ii
autismem	aw t i s m e m
až	a sh
b	b ee
babiš	b a b i sh
babiše	b a b i sh e
babišem	b a b i sh e m
babišovi	b a b i sh o v i
babišových	b a b i sh o v ii x
barbora	b a r b o r a
barty	b a r t i
baru	b a r u
barvách	b a r v aa x
benzín	b e n z ii n
benzínem	b e n z ii n e m
benzínu	b e n z ii n u
berdych	b e r d i x
bere	b e r e
bez	b e s
bezmála	b e z m aa l a
bezpečnostní	b e s p e ch n o s t nj ii
bezpečnostních	b e s p e ch n o s t nj ii x
bezpečné	b e s p e ch n ee
bezpečnými	b e s p e ch n ii m i
bezprostředně	b e s p r o s t rsh e d nj e
bicyklu	b i c i k l u
bilance	b i l a n c e
bill	b i l
blokoval	b l o k o v a l
blíží	b l ii zh ii
blížícího	b l ii zh ii c ii h o
bohužel	b o h u zh e l
boj	b o j
boji	b o j i
bojovat	b o j o v a t
bojují	b o j u j ii
bolestivá	b o l e s tj i v aa
bond	b o n t
bound	b ow n t
bourke	b ow r k e
bratra	b r a t r a
brazílii	b r a z ii l i j i
break	b r e a k
brisbane	b r i z b a n e
bublinu	b u b l i n u
bude	b u d e
budou	b u d ow
budoucí	b u d ow c ii
budoucími	b u d ow c ii m i
budovu	b u d o v u
buše	b u sh e
by	b i
bych	b i x
bydlení	b i d l e nj ii
byl	b i l
byla	b i l a
byli	b i l i
bylo	b i l o
byly	b i l i
byt	b i t
byty	b i t i
bytě	b i tj e
bytů	b i t uu
byznysu	b i z n i s u
bílém	b ii l ee m
být	b ii t
bývalého	b ii v a l ee h o
bývalý	b ii v a l ii
během	b j e h e m
březen	b rzh e z e n
března	b rzh e z n a
canbeře	k e n b e rzh e
celkově	c e l k o v j e
celá	c e l aa
celého	c e l ee h o
celém	c e l ee m
celý	c e l ii
cena	c e n a
centra	c e n t r a
centre	c e n t r e
centru	c e n t r u
ceny	c e n i
ceremoniálu	c e r e m o n i j aa l u
cesta	c e s t a
cestovatel	c e s t o v a t e l
cestovního	c e s t o v nj ii h o
cestu	c e s t u
cestuje	c e s t u j e
cesty	c e s t i
cestě	c e s tj e
chata	x a t a
chce	x c e
chinaski	x i n a s k i
christchurch	x r i s t x u r x
christchurchi	x r i s t x u r x i
christoff	x r i s t o f
chtěl	x tj e l
chtěla	x tj e l a
chudoby	x u d o b i
chvilku	x v i l k u
chválila	x v aa l i l a
chyba	x i b a
chyby	x i b i
chybět	x i b j e t
chystá	x i s t aa
chápání	x aa p aa nj ii
cia	c i a
cihlová	c i h l o v aa
civilizované	c i v i l i z o v a n ee
cizích	c i z ii x
co	k o
collins	k o l i n s
což	c o sh
cyklista	c i k l i s t a
cyklo	c i k l o
cykloturista	c i k l o t u r i s t a
cyklus	c i k l u s
cyklónů	c i k l oo n uu
czech	ch z e x
cíl	c ii l
cílem	c ii l e m
cílí	c ii l ii
dají	d a j ii
dala	d a l a
daleko	d a l e k o
dalo	d a l o
další	d a l sh ii
dalších	d a l sh ii x
dalším	d a l sh ii m
danielle	d a n i j e l l
daní	d a nj ii
darling	d a r l i ng k
davů	d a v uu
daří	d a rzh ii
dc	d ee c ee
de	d e
debatu	d e b a t u
deblistky	d e b l i s t k i
den	d e n
denní	d e nj ii
deportace	d e p o r t a c e
deset	d e s e t
desetiletí	d e s e tj i l e tj ii
destinacemi	d e s tj i n a c e m i
desítky	d e s ii t k i
detrich	d ii t r i x
devastuje	d e v a s t u j e
dešti	d e sh tj i
dietní	d i j e t nj ii
digitální	d i g i t aa l nj ii
diskutovala	d i s k u t o v a l a
diskutuje	d i s k u t u j e
dispozici	d i s p o z i c i
divokých	dj i v o k ii x
diváci	dj i v aa c i
dlouho	d l ow h o
dlouhodobé	d l ow h o d o b ee
dlouhou	d l ow h ow
dlouhý	d l ow h ii
dluhy	d l u h i
dne	d n e
dnem	d n e m
dnes	d n e s
dnešní	d n e sh nj ii
dní	d nj ii
do	d o
dobu	d o b u
doby	d o b i
době	d o b j e
dobře	d o b rzh e
docela	d o c e l a
dodala	d o d a l a
dodává	d o d aa v aa
dohromady	d o h r o m a d i
dojezdové	d o j e z d o v ee
dojíždění	d o j ii zh dj e nj ii
dokončil	d o k o n ch i l
doktora	d o k t o r a
doktorský	d o k t o r s k ii
dokumentu	d o k u m e n t u
dokázala	d o k aa z a l a
dolarů	d o l a r uu
domorodých	d o m o r o d ii x
domácí	d o m aa c ii
domě	d o m nj e
domů	d o m uu
donald	d o n a l t
donalda	d o n a l d a
dopadly	d o p a d l i
doporučují	d o p o r u ch u j ii
doposud	d o p o s u t
dopravena	d o p r a v e n a
dospělých	d o s p j e l ii x
dostali	d o s t a l i
dostat	d o s t a t
dostatečnou	d o s t a t e ch n ow
dostupné	d o s t u p n ee
dotací	d o t a c ii
dotačním	d o t a ch nj ii m
dotknout	d o t k n ow t
doublu	d a b l u
doufají	d ow f a j ii
doufá	d ow f aa
dovolat	d o v o l a t
dovést	d o v ee s t
dočkat	d o ch k a t
došla	d o sh l a
došlápla	d o sh l aa p l a
dramaticky	d r a m a t i c k i
dramatické	d r a m a t i c k ee
drceni	d r c e nj i
druhá	d r u h aa
druhé	d r u h ee
druhého	d r u h ee h o
druhý	d r u h ii
druhů	d r u h uu
druzích	d r u z ii x
drůbeže	d r uu b e zh e
držení	d r zh e nj ii
duba	d u b a
dutton	d a t n
dva	d v a
dvojku	d v o j k u
dvojnásobná	d v o j n aa s o b n aa
dvou	d v ow
dvořáka	d v o rzh aa k a
dvě	d v j e
dvěma	d v j e m a
dál	d aa l
dánsko	d aa n s k o
dávala	d aa v a l a
dávno	d aa v n o
dává	d aa v aa
dávání	d aa v aa nj ii
déle	d ee l e
díky	dj ii k i
dívá	dj ii v aa
dědečka	dj e d e ch k a
děkuji	dj e k u j i
dělat	dj e l a t
dělá	dj e l aa
děsivém	dj e s i v ee m
dětem	dj e t e m
dětmi	dj e t m i
dětské	dj e t s k ee
dětí	dj e tj ii
dříve	d rzh ii v e
důchodové	d uu x o d o v ee
důchodu	d uu x o d u
důležitá	d uu l e zh i t aa
důležité	d uu l e zh i t ee
důležitější	d uu l e zh i tj e j sh ii
důsledkem	d uu s l e t k e m
důvod	d uu v o t
důvodem	d uu v o d e m
důvody	d uu v o d i
důvodů	d uu v o d uu
efekt	e f e k t
efektivně	e f e k t i v nj e
ekonomice	e k o n o m i c e
ekonomicky	e k o n o m i c k i
ekonomika	e k o n o m i k a
elitní	e l i t nj ii
esp	e s p
etické	e t i c k ee
evidentní	e v i d e n t nj ii
evropské	e v r o p s k ee
evropském	e v r o p s k ee m
evropy	e v r o p i
evropě	e v r o p j e
exekučně	e g z e k u ch nj e
experti	e k s p e r tj i
exportérem	e k s p o r t ee r e m
extrémní	e k s t r ee m nj ii
fakt	f a k t
famózní	f a m oo z nj ii
fanouškovskou	f a n ow sh k o f s k ow
fanoušky	f a n ow sh k i
fanoušků	f a n ow sh k uu
farma	f a r m a
farmáře	f a r m aa rzh e
farmáři	f a r m aa rzh i
favoritka	f a v o r i t k a
federální	f e d e r aa l nj ii
federálního	f e d e r aa l nj ii h o
festival	f e s t i v a l
festivalu	f e s t i v a l u
film	f i l m
filmových	f i l m o v ii x
filmů	f i l m uu
finančními	f i n a n ch nj ii m i
finále	f i n aa l e
fondu	f o n d u
formu	f o r m u
formát	f o r m aa t
fotbalista	f o d b a l i s t a
fotografie	f o t o g r a f i j e
frydenberg	f r i d e n b e r k
fuel	f u e l
funguje	f u ng g u j e
funkci	f u ng k c i
férovou	f ee r o v ow
g	g ee
gabrine	g a b r i n e
garbine	g a r b i n e
generace	g e n e r a c e
ginou	g i n ow
globální	g l o b aa l nj ii
graham	g r a h a m
grandslamu	g r a n t s l a m u
grant	g r a n t
granty	g r a n t i
gras	g r a s
grattanův	g r a t a n uu f
gratuluji	g r a t u l u j i
hadi	h a dj i
halep	h a l e p
hana	h a n a
hanka	h a ng k a
harry	h a r r i
haspel	h a s p e l
helena	h e l e n a
historický	h i s t o r i c k ii
historii	h i s t o r i j i
hit	h i t
hladce	h l a t c e
hladina	h l a dj i n a
hladké	h l a t k ee
hlasitost	h l a s i t o s t
hlasovalo	h l a s o v a l o
hlavní	h l a v nj ii
hledat	h l e d a t
hledání	h l e d aa nj ii
hledáčku	h l e d aa ch k u
hlásí	h l aa s ii
hlídací	h l ii d a c ii
hmot	h m o t
hmyzu	h m i s u
hnutí	h n u tj ii
hnízdo	h nj ii z d o
ho	h o
hodinu	h o dj i n u
hodiny	h o dj i n i
hodinách	h o dj i n aa x
hodině	h o dj i nj e
hodnotil	h o d n o tj i l
hodnotí	h o d n o tj ii
hodnotě	h o d n o tj e
hodně	h o d nj e
hoffman	h o f m a n
hoffmana	h o f m a n a
hoffmanem	h o f m a n e m
hold	h o l t
homeward	h ow m v a r t
honzejk	h o n z e j k
honzejkem	h o n z e j k e m
horká	h o r k aa
hospitalizováno	h o s p i t a l i z o v aa n o
hospodář	h o s p o d aa rsh
hospodáři	h o s p o d aa rzh i
hostem	h o s t e m
houdová	h ow d o v aa
hovoří	h o v o rzh ii
hovoříme	h o v o rzh ii m e
hovězím	h o v j e z ii m
hraje	h r a j e
hranicí	h r a nj i c ii
hrdě	h r dj e
hromadnému	h r o m a d n ee m u
hrozí	h r o z ii
hru	h r u
hrál	h r aa l
hrála	h r aa l a
hrát	h r aa t
hráček	h r aa ch e k
hráči	h r aa ch i
hráčka	h r aa ch k a
hráčkou	h r aa ch k ow
hráčky	h r aa ch k i
huawei	h u a v e i
hudba	h u d b a
hudební	h u d e b nj ii
hymny	h i m n i
i	i
ikou	i k ow
improvizovanými	i m p r o v i z o v a n ii m i
incident	i n c i d e n t
indexu	i n d e k s u
indickou	i n d i c k ow
informace	i n f o r m a c e
informací	i n f o r m a c ii
infrastrukturu	i n f r a s t r u k t u r u
institut	i n s t i t u t
integraci	i n t e g r a c i
interview	i n t e r v i u
investičního	i n v e s t i ch nj ii h o
ivan	i v a n
ivana	i v a n a
ivanem	i v a n e m
jak	j a k
jako	j a k o
jakoukoliv	j a k ow k o l i f
jaká	j a k aa
jaké	j a k ee
jaký	j a k ii
jan	j a n
janda	j a n d a
japonci	j a p o n c i
japonka	j a p o ng k a
japonska	j a p o n s k a
jasné	j a s n ee
jasnými	j a s n ii m i
jazyka	j a z i k a
jazykem	j a z i k e m
jazyky	j a z i k i
jazyků	j a z i k uu
jde	j d e
je	j e
jeden	j e d e n
jedinou	j e dj i n ow
jediná	j e dj i n aa
jediném	j e dj i n ee m
jedna	j e d n a
jedni	j e d nj i
jedničkou	j e d nj i ch k ow
jedničku	j e d nj i ch k u
jedno	j e d n o
jednoduše	j e d n o d u sh e
jednoho	j e d n o h o
jednou	j e d n ow
jednu	j e d n u
jedny	j e d n i
jedné	j e d n ee
jedním	j e d nj ii m
jedovatí	j e d o v a tj ii
jeho	j e h o
jejich	j e j i x
její	j e j ii
jejích	j e j ii x
jejím	j e j ii m
jen	j e n
jenže	j e n zh e
ji	j i
jich	j i x
jihu	j i h u
jim	j i m
jinak	j i n a k
jiné	j i n ee
jiní	j i nj ii
jinými	j i n ii m i
jistější	j i s tj e j sh ii
jižního	j i zh nj ii h o
jižním	j i zh nj ii m
josh	j o sh
jsem	j s e m
jsme	j s m e
jsou	j s ow
jí	j ii
jídlo	j ii d l o
jít	j ii t
k	k aa
kampaně	k a m p a nj e
kampaň	k a m p a nj
kantora	k a n t o r a
kantorovi	k a n t o r o v i
kapacity	k a p a c i t i
kapela	k a p e l a
kariéře	k a r i j ee rzh e
karolína	k a r o l ii n a
katastrofami	k a t a s t r o f a m i
katastrofy	k a t a s t r o f i
kateřina	k a t e rzh i n a
kauci	k aw c i
kauzy	k aw z i
každodenní	k a zh d o d e nj ii
každopádně	k a zh d o p aa d nj e
každá	k a zh d aa
každý	k a zh d ii
kde	g d e
kdo	g d o
kdy	g d i
když	g d i sh
ke	k e
kick	k i k
kilometrů	k i l o m e t r uu
kitesurfovou	k i t e s u r f o v ow
klaus	k l aw s
klementinu	k l e m e n t i n u
klepač	k l e p a ch
klesla	k l e s l a
klesá	k l e s aa
klidně	k l i d nj e
klimatickou	k l i m a t i c k ow
klimatická	k l i m a t i c k aa
klimatické	k l i m a t i c k ee
klimatickým	k l i m a t i c k ii m
klimatickými	k l i m a t i c k ii m i
klubů	k l u b uu
knedlo	k n e d l o
knih	k nj i x
knihovnami	k nj i h o v n a m i
koaliční	k o a l i ch nj ii
koaličního	k o a l i ch nj ii h o
koaly	k o a l i
koberec	k o b e r e c
kole	k o l e
kolem	k o l e m
kolo	k o l o
kombinace	k o m b i n a c e
komentuje	k o m e n t u j e
komentátora	k o m e n t aa t o r a
komentátorem	k o m e n t aa t o r e m
komerčního	k o m e r ch nj ii h o
komponentu	k o m p o n e n t u
komunikačních	k o m u n i k a ch nj ii x
komunitami	k o m u n i t a m i
komunitách	k o m u n i t aa x
komunitě	k o m u n i tj e
komunální	k o m u n aa l nj ii
konce	k o n c e
koncertem	k o n c e r t e m
koncertovat	k o n c e r t o v a t
konci	k o n c i
konference	k o n f e r e n c e
konfliktu	k o n f l i k t u
kontaminovaným	k o n t a m i n o v a n ii m
kontextu	k o n t e k s t u
kontrol	k o n t r o l
kontrolovali	k o n t r o l o v a l i
kontrolu	k o n t r o l u
kontrolách	k o n t r o l aa x
konzumace	k o n z u m a c e
končit	k o n ch i t
končí	k o n ch ii
kotníkem	k o t nj ii k e m
kouření	k ow rzh e nj ii
kováře	k o v aa rzh e
kradou	k r a d ow
krajani	k r a j a nj i
krajany	k r a j a n i
krajiny	k r a j i n i
krajině	k r a j i nj e
kraťasy	k r a tj a s i
kreativní	k r e a t i v nj ii
krejčíková	k r e j ch ii k o v aa
kritice	k r i t i c e
kritika	k r i t i k a
krok	k r o k
kroku	k r o k u
kromě	k r o m nj e
krym	k r i m
krymské	k r i m s k ee
královské	k r aa l o f s k ee
krásný	k r aa s n ii
krátkodobé	k r aa t k o d o b ee
krátký	k r aa t k ii
kterou	k t e r ow
která	k t e r aa
které	k t e r ee
kterého	k t e r ee h o
kterém	k t e r ee m
který	k t e r ii
kterým	k t e r ii m
kteří	k t e rzh ii
kulatého	k u l a t ee h o
kulturu	k u l t u r u
kultury	k u l t u r i
kurnell	k u r n e l
kurtu	k u r t u
kurty	k u r t i
kurtů	k u r t uu
kvitová	k v i t o v aa
kvitové	k v i t o v ee
května	k v j e t n a
květnem	k v j e t n e m
květnových	k v j e t n o v ii x
kvůli	k v uu l i
laboratoři	l a b o r a t o rzh i
laver	l a v e r
leadra	l ii d r a
ledna	l e d n a
legendu	l e g e n d u
legionáře	l e g i j o n aa rzh e
legiích	l e g i j ii x
legrace	l e g r a c e
let	l e t
letos	l e t o s
letošní	l e t o sh nj ii
lety	l e t i
letá	l e t aa
letého	l e t ee h o
levé	l e v ee
lidem	l i d e m
lidi	l i dj i
lidí	l i dj ii
lodi	l o dj i
loni	l o nj i
lovu	l o v u
loňské	l o nj s k ee
ludmila	l u d m i l a
luxusní	l u k s u s nj ii
lákavější	l aa k a v j e j sh ii
lékařských	l ee k a rsh s k ii x
léky	l ee k i
lépe	l ee p e
léto	l ee t o
létě	l ee tj e
líbí	l ii b ii
lídr	l ii d r
m	m
majetek	m a j e t e k
majetku	m a j e t k u
mají	m a j ii
malcolm	m a l k o l m
manažmentu	m a n a zh m e n t u
manžel	m a n zh e l
manželství	m a n zh e l s t v ii
mardi	m a r d i
margaret	m a r g a r e t
marii	m a r i j i
markéta	m a r k ee t a
martinez	m a r tj i n e s
masa	m a s a
masakr	m a s a k r
masakru	m a s a k r u
masaryka	m a s a r i k a
masu	m a s u
matchbolu	m e ch b o l u
matchboly	m e ch b o l i
mateřským	m a t e rsh s k ii m
mbs	m p s
meghan	m e g h e n
melbourne	m e l b ow r n e
melbournském	m e l b ow r n s k ee m
messim	m e s i m
mezi	m e z i
mezinárodní	m e z i n aa r o d nj ii
mezinárodních	m e z i n aa r o d nj ii x
mešit	m e sh i t
mešitách	m e sh i t aa x
mi	m i
migrace	m i g r a c e
migraci	m i g r a c i
migranty	m i g r a n t i
migrantů	m i g r a n t uu
mikrofonem	m i k r o f o n e m
milana	m i l a n a
milanu	m i l a n u
miliard	m i l i j a r t
miliardu	m i l i j a r d u
miliardy	m i l i j a r d i
miliardě	m i l i j a r dj e
milion	m i l i j o n
milionu	m i l i j o n u
milionů	m i l i j o n uu
miláčkem	m i l aa ch k e m
mimo	m i m o
mimořádný	m i m o rzh aa d n ii
ministerský	m i n i s t e r s k ii
ministr	m i n i s t r
ministra	m i n i s t r a
minut	m i n u t
miss	m i s
mixuje	m i k s u j e
ml	m l
mladičkou	m l a dj i ch k ow
mladých	m l a d ii x
mladší	m l a t sh ii
mladšího	m l a t sh ii h o
mluvit	m l u v i t
mluvící	m l u v ii c ii
mnoha	m n o h a
mnohem	m n o h e m
mnoho	m n o h o
mnohonásobnou	m n o h o n aa s o b n ow
mnohonásobné	m n o h o n aa s o b n ee
mnozí	m n o z ii
množství	m n o sh s t v ii
mobilních	m o b i l nj ii x
moc	m o c
moci	m o c i
modelky	m o d e l k i
mohla	m o h l a
mohli	m o h l i
mohlo	m o h l o
mohly	m o h l i
mohou	m o h ow
monarchie	m o n a r x i j e
monash	m o n a sh
morrison	m o r i s o n
morrisonovi	m o r i s o n o v i
morrisonovy	m o r i s o n o v i
most	m o s t
motivace	m o t i v a c e
motoristé	m o t o r i s t ee
moři	m o rzh i
mořská	m o rsh s k aa
mořští	m o rsh sh tj ii
možná	m o zh n aa
mrkvička	m r k v i ch k a
mu	m u
muguruza	m u g u r u z a
muguruzu	m u g u r u z u
musí	m u s ii
muž	m u sh
muže	m u zh e
mužů	m u zh uu
myslí	m i s l ii
myslím	m i s l ii m
mzdu	m z d u
má	m aa
mám	m aa m
mému	m ee m u
méně	m ee nj e
míra	m ii r a
místa	m ii s t a
místního	m ii s t nj ii h o
místo	m ii s t o
místě	m ii s tj e
mít	m ii t
mířili	m ii rzh i l i
módních	m oo d nj ii x
módě	m oo dj e
mýtů	m ii t uu
mě	m nj e
měl	m nj e l
měla	m nj e l a
měli	m nj e l i
mělo	m nj e l o
mění	m nj e nj ii
měrou	m nj e r ow
měst	m nj e s t
města	m nj e s t a
městech	m nj e s t e x
městského	m nj e s t s k ee h o
městě	m nj e s tj e
měsíce	m nj e s ii c e
měsíci	m nj e s ii c i
měsíců	m nj e s ii c uu
měření	m nj e rzh e nj ii
můj	m uu j
může	m uu zh e
můžeme	m uu zh e m e
můžete	m uu zh e t e
na	n a
nabádají	n a b aa d a j ii
nabídnout	n a b ii d n ow t
nabízí	n a b ii z ii
nad	n a t
nadala	n a d a l a
nadále	n a d aa l e
nadšení	n a t sh e nj ii
nahlášena	n a h l aa sh e n a
nahlédnutí	n a h l ee d n u tj ii
najít	n a j ii t
nakonec	n a k o n e c
naletí	n a l e tj ii
naměřila	n a m nj e rzh i l a
naomi	n a o m i
naopak	n a o p a k
napadení	n a p a d e nj ii
naposledy	n a p o s l e d i
napětí	n a p j e tj ii
například	n a p rsh ii k l a t
narazil	n a r a z i l
narodil	n a r o dj i l
narodilo	n a r o dj i l o
narozdíl	n a r o z dj ii l
narážela	n a r aa zh e l a
nastavené	n a s t a v e n ee
nastínil	n a s tj ii nj i l
nastínit	n a s tj ii nj i t
natočili	n a t o ch i l i
naturalizačním	n a t u r a l i z a ch nj ii m
navrch	n a v r x
navíc	n a v ii c
navštívila	n a f sh tj ii v i l a
navštíví	n a f sh tj ii v ii
naznačována	n a z n a ch o v aa n a
naďa	n a dj a
naše	n a sh e
našeho	n a sh e h o
našla	n a sh l a
naším	n a sh ii m
neanglicky	n e a ng g l i c k i
nebezpečími	n e b e s p e ch ii m i
nebo	n e b o
nebude	n e b u d e
nebudeme	n e b u d e m e
nechtěla	n e x tj e l a
nedaleko	n e d a l e k o
nedokázaly	n e d o k aa z a l i
nedostane	n e d o s t a n e
nedostatek	n e d o s t a t e k
nedá	n e d aa
nedávno	n e d aa v n o
neděle	n e dj e l e
neděli	n e dj e l i
nefér	n e f ee r
nejdelší	n e j d e l sh ii
nejen	n e j e n
nejhorším	n e j h o r sh ii m
nejlepší	n e j l e p sh ii
nejoblíbenější	n e j o b l ii b e nj e j sh ii
nejprve	n e j p r v e
nejsou	n e j s ow
nejsušší	n e j s u sh ii
nejtemnější	n e j t e m nj e j sh ii
nejteplejší	n e j t e p l e j sh ii
nejvíc	n e j v ii c
nejvíce	n e j v ii c e
největší	n e j v j e t sh ii
nejznámějších	n e j z n aa m nj e j sh ii x
nekombinujte	n e k o m b i n u j t e
nemluví	n e m l u v ii
nemocného	n e m o c n ee h o
nemožné	n e m o zh n ee
nemusejí	n e m u s e j ii
nemyslím	n e m i s l ii m
neměl	n e m nj e l
neměla	n e m nj e l a
nenávistných	n e n aa v i s t n ii x
není	n e nj ii
neoprávněného	n e o p r aa v nj e n ee h o
nepodepíšou	n e p o d e p ii sh ow
neposkytlo	n e p o s k i t l o
nepovažovala	n e p o v a zh o v a l a
nepovedlo	n e p o v e d l o
neproměnily	n e p r o m nj e nj i l i
nepustila	n e p u s tj i l a
nesmělo	n e s m nj e l o
nesouhlas	n e s ow h l a s
nesouvisely	n e s ow v i s e l i
neudělalo	n e u dj e l a l o
neuvěřitelné	n e u v j e rzh i t e l n ee
nevhodného	n e v h o d n ee h o
nevypadá	n e v i p a d aa
nevyplácela	n e v i p l aa c e l a
nevídaný	n e v ii d a n ii
nezhoršilo	n e z h o r sh i l o
nezvládla	n e z v l aa d l a
nezávislý	n e z aa v i s l ii
nešťastné	n e sh tj a s t n ee
než	n e sh
nežádoucí	n e zh aa d ow c ii
ni	nj i
nic	nj i c
nich	nj i x
north	n o r d x
novinky	n o v i ng k i
novináři	n o v i n aa rzh i
novou	n o v ow
novozélandská	n o v o z ee l a n t s k aa
novozélandském	n o v o z ee l a n t s k ee m
nová	n o v aa
nové	n o v ee
nového	n o v ee h o
novém	n o v ee m
nový	n o v ii
nových	n o v ii x
novější	n o v j e j sh ii
nutriční	n u t r i ch nj ii
nyní	n i nj ii
náboženském	n aa b o zh e n s k ee m
náboženských	n aa b o zh e n s k ii x
náboženství	n aa b o zh e n s t v ii
náhody	n aa h o d i
nákupem	n aa k u p e m
národ	n aa r o t
národním	n aa r o d nj ii m
národů	n aa r o d uu
nározy	n aa r o z i
náročné	n aa r o ch n ee
následovníkovi	n aa s l e d o v nj ii k o v i
následujících	n aa s l e d u j ii c ii x
následujícím	n aa s l e d u j ii c ii m
násobně	n aa s o b nj e
nástup	n aa s t u p
nástupu	n aa s t u p u
návrat	n aa v r a t
návyky	n aa v i k i
návštěva	n aa f sh tj e v a
návštěvníci	n aa f sh tj e v nj ii c i
návštěvníky	n aa f sh tj e v nj ii k i
náš	n aa sh
ní	nj ii
nízko	nj ii s k o
něco	nj e c o
něj	nj e j
nějak	nj e j a k
nějaká	nj e j a k aa
nějaké	nj e j a k ee
nějakému	nj e j a k ee m u
někde	nj e g d e
někdy	nj e g d i
několik	nj e k o l i k
některé	nj e k t e r ee
někteří	nj e k t e rzh ii
něm	nj e m
německu	nj e m e c k u
něž	nj e sh
o	o
obavou	o b a v ow
období	o b d o b ii
obdory	o b d o r i
obecních	o b e c nj ii x
obhajoval	o b h a j o v a l
obhájci	o b h aa j c i
objezd	o b j e s t
oblastech	o b l a s t e x
oblastmi	o b l a s t m i
obnovilo	o b n o v i l o
oboru	o b o r u
obrovská	o b r o f s k aa
obtížemi	o p tj ii zh e m i
obtížnější	o p tj ii zh nj e j sh ii
obvykle	o b v i k l e
obvyklé	o b v i k l ee
obyvatel	o b i v a t e l
obávat	o b aa v a t
obírají	o b ii r a j ii
občanem	o p ch a n e m
občanství	o p ch a n s t v ii
obě	o b j e
obědu	o b j e d u
oběma	o b j e m a
oceněn	o c e nj e n
oceněno	o c e nj e n o
oceněny	o c e nj e n i
oceněných	o c e nj e n ii x
ochránit	o x r aa nj i t
od	o d
odborových	o d b o r o v ii x
odcházel	o d x aa z e l
odehraných	o d e h r a n ii x
odejit	o d e j i t
odevzdal	o d e v z d a l
odhaduje	o d h a d u j e
odhaleno	o d h a l e n o
odhlasovali	o d h l a s o v a l i
odkráčela	o d k r aa ch e l a
odkud	o d k u t
odmítají	o d m ii t a j ii
odpadní	o d p a d nj ii
odpoledních	o d p o l e d nj ii x
odpovědí	o d p o v j e dj ii
odpovědích	o d p o v j e dj ii x
odpověď	o d p o v j e tj
ods	o d s
odsolovací	o d s o l o v a c ii
odsolování	o d s o l o v aa nj ii
odvodech	o d v o d e x
odvolán	o d v o l aa n
odvrátit	o d v r aa tj i t
odvážném	o d v aa zh n ee m
odvětví	o d v j e t v ii
oficiálně	o f i c i j aa l nj e
ohlédnu	o h l ee d n u
ohniska	o h nj i s k a
ohrožena	o h r o zh e n a
ohroženi	o h r o zh e nj i
ohrožených	o h r o zh e n ii x
okolnostech	o k o l n o s t e x
olejářským	o l e j aa rsh s k ii m
ombudsmanem	o m b u t s m a n e m
opakuje	o p a k u j e
opal	o p a l
opatření	o p a t rsh e nj ii
opačného	o p a ch n ee h o
open	ow p n
opery	o p e r i
operátoři	o p e r aa t o rzh i
opozice	o p o z i c e
opravdu	o p r a v d u
oproti	o p r o tj i
opět	o p j e t
organismy	o r g a n i z m i
organizace	o r g a n i z a c e
orientace	o r i j e n t a c e
osaka	o s a k a
osaky	o s a k i
oslav	o s l a f
oslava	o s l a v a
oslavu	o s l a v u
oslavy	o s l a v i
oslaví	o s l a v ii
oslavíme	o s l a v ii m e
osm	o s m
osobně	o s o b nj e
osobu	o s o b u
ostatních	o s t a t nj ii x
otevřená	o t e v rzh e n aa
otevřeném	o t e v rzh e n ee m
otočit	o t o ch i t
otroctví	o t r o c t v ii
otázek	o t aa z e k
otázka	o t aa s k a
otázkách	o t aa s k aa x
outbacku	ow t b e k u
ovládla	o v l aa d l a
ovoce	o v o c e
označují	o z n a ch u j ii
očekávaném	o ch e k aa v a n ee m
očekává	o ch e k aa v aa
očkování	o ch k o v aa nj ii
očkováním	o ch k o v aa nj ii m
p	p ee
pak	p a k
pakt	p a k t
palach	p a l a x
památky	p a m aa t k i
paměti	p a m nj e tj i
parlamentu	p a r l a m e n t u
partnerky	p a r t n e r k i
pasivně	p a s i v nj e
patnáct	p a t n aa c t
patří	p a t rsh ii
pauze	p aw z e
pavouci	p a v ow c i
pechová	p e x o v aa
penzista	p e n z i s t a
peníze	p e nj ii z e
perfektní	p e r f e k t nj ii
perth	p e r d x
perthu	p e r d h u
pes	p e s
peter	p e t e r
petr	p e t r
petra	p e t r a
petrem	p e t r e m
petry	p e t r i
petře	p e t rsh e
pečlivě	p e ch l i v j e
pijí	p i j ii
pitná	p i t n aa
plachet	p l a x e t
planety	p l a n e t i
platili	p l a tj i l i
platit	p l a tj i t
platí	p l a tj ii
plavba	p l a v b a
ples	p l e s
plošný	p l o sh n ii
plošných	p l o sh n ii x
plán	p l aa n
plánem	p l aa n e m
plánované	p l aa n o v a n ee
plánovat	p l aa n o v a t
plánována	p l aa n o v aa n a
plánuje	p l aa n u j e
plíšková	p l ii sh k o v aa
po	p o
pobytu	p o b i t u
pobřeží	p o b rzh e zh ii
pochod	p o x o t
pochybení	p o x i b e nj ii
pod	p o d
podařilo	p o d a rzh i l o
podivných	p o d i v n ii x
podle	p o d l e
podmínek	p o d m ii n e k
podmínky	p o d m ii ng k i
podnikají	p o d nj i k a j ii
podobně	p o d o b nj e
podotkla	p o d o t k l a
podporou	p o d p o r ow
podporovala	p o d p o r o v a l a
podporu	p o d p o r u
podrobnosti	p o d r o b n o s tj i
podvodníkovi	p o d v o d nj ii k o v i
podvodných	p o d v o d n ii x
podvody	p o d v o d i
podávají	p o d aa v a j ii
podávalo	p o d aa v a l o
podílí	p o dj ii l ii
podívala	p o d ii v a l a
podívejme	p o dj ii v e j m e
pogratulovaly	p o g r a t u l o v a l i
pohlaví	p o h l a v ii
pohled	p o h l e t
pohledu	p o h l e d u
pohonných	p o h o n ii x
pohostinství	p o h o s tj i n s t v ii
pohromám	p o h r o m aa m
pojetí	p o j e tj ii
pojišťovny	p o j i sh tj o v n i
poklesla	p o k l e s l a
poklesu	p o k l e s u
pokud	p o k u t
pokyny	p o k i n i
polakovič	p o l a k o v i ch
polakoviče	p o l a k o v i ch e
policie	p o l i c i j e
politice	p o l i t i c e
politici	p o l i t i c i
politickou	p o l i t i c k ow
politik	p o l i t i k
politička	p o l i t i ch k a
poloostrova	p o l o o s t r o v a
polovina	p o l o v i n a
polovinu	p o l o v i n u
polovině	p o l o v i nj e
poloviční	p o l o v i ch nj ii
položen	p o l o zh e n
polska	p o l s k a
polskému	p o l s k ee m u
pomoci	p o m o c i
poměrně	p o m nj e r nj e
pondělním	p o nj dj e l nj ii m
poprvé	p o p r v ee
popsal	p o p s a l
popsala	p o p s a l a
poptávku	p o p t aa f k u
populaci	p o p u l a c i
populačního	p o p u l a ch nj ii h o
populární	p o p u l aa r nj ii
poranění	p o r a nj e nj ii
porazil	p o r a z i l
porazila	p o r a z i l a
porazit	p o r a z i t
poražen	p o r a zh e n
porážka	p o r aa sh k a
porážkám	p o r aa sh k aa m
poskytl	p o s k i t l
poslechnout	p o s l e x n ow t
poslední	p o s l e d nj ii
posledních	p o s l e d nj ii x
posledním	p o s l e d nj ii m
posledně	p o s l e d nj e
poslouchá	p o s l ow x aa
posluchačů	p o s l u x a ch uu
postaví	p o s t a v ii
postojích	p o s t o j ii x
postoupil	p o s t ow p i l
postupné	p o s t u p n ee
postupuje	p o s t u p u j e
postupují	p o s t u p u j ii
posunula	p o s u n u l a
potkaly	p o t k a l i
potlačila	p o t l a ch i l a
potom	p o t o m
potrvá	p o t r v aa
potvrdil	p o t v r dj i l
potvrdila	p o t v r dj i l a
poté	p o t ee
potírané	p o tj ii r a n ee
potřeba	p o t rsh e b a
potřebnou	p o t rsh e b n ow
potřesení	p o t rsh e s e nj ii
pouhá	p ow h aa
pouhém	p ow h ee m
pouhých	p ow h ii x
používá	p ow zh ii v aa
považované	p o v a zh o v a n ee
povinný	p o v i n ii
povinných	p o v i n ii x
povodní	p o v o d nj ii
povodněmi	p o v o d nj e m i
povodí	p o v o dj ii
povolení	p o v o l e nj ii
povrchu	p o v r x u
pověření	p o v j e rzh e nj ii
pozadí	p o z a dj ii
později	p o z dj e j i
pozitivně	p o z i t i v nj e
poznámky	p o z n aa m k i
pozornosti	p o z o r n o s tj i
pozvání	p o z v aa nj ii
počasí	p o ch a s ii
počet	p o ch e t
počtu	p o ch t u
pořadí	p o rzh a dj ii
pořádného	p o rzh aa d n ee h o
pořádá	p o rzh aa d aa
poškození	p o sh k o z e nj ii
požaduje	p o zh a d u j e
požadují	p o zh a d u j ii
požáry	p o zh aa r i
požárů	p o zh aa r uu
pracoval	p r a c o v a l
pracovala	p r a c o v a l a
pracovní	p r a c o v nj ii
pracovníci	p r a c o v nj ii c i
pracovníky	p r a c o v nj ii k i
pracovníků	p r a c o v nj ii k uu
pracovníkům	p r a c o v nj ii k uu m
pracuje	p r a c u j e
pracují	p r a c u j ii
prahy	p r a h i
praktik	p r a k t i k
praktikují	p r a k t i k u j ii
praktiky	p r a k t i k i
pravdu	p r a v d u
pravděpodobností	p r a v dj e p o d o b n o s tj ii
pravděpodobně	p r a v dj e p o d o b nj e
pravicového	p r a v i c o v ee h o
praxi	p r a k s i
praze	p r a z e
preferovaný	p r e f e r o v a n ii
premiér	p r e m i j ee r
premiéra	p r e m i j ee r a
premiérem	p r e m i j ee r e m
premiérovi	p r e m i j ee r o v i
prestižní	p r e s t i zh nj ii
prevence	p r e v e n c e
prezident	p r e z i d e n t
prezidenta	p r e z i d e n t a
prezidentku	p r e z i d e n t k u
princ	p r i n c
prioritou	p r i j o r i t ow
pro	p r o
problém	p r o b l ee m
problému	p r o b l ee m u
probojovala	p r o b o j o v a l a
probíhají	p r o b ii h a j ii
probíhal	p r o b ii h a l
proběhlo	p r o b j e h l o
procent	p r o c e n t
procentech	p r o c e n t e x
procestoval	p r o c e s t o v a l
procházejí	p r o x aa z e j ii
prodej	p r o d e j
prodloužit	p r o d l ow zh i t
profesionálů	p r o f e s i j o n aa l uu
program	p r o g r a m
programu	p r o g r a m u
prohraném	p r o h r a n ee m
prohry	p r o h r i
prohrála	p r o h r aa l a
projet	p r o j e t
prokázali	p r o k aa z a l i
promítal	p r o m ii t a l
prosince	p r o s i n c e
prosperující	p r o s p e r u j ii c ii
prospěchu	p r o s p j e x u
prostě	p r o s tj e
protest	p r o t e s t
proti	p r o tj i
protiromském	p r o tj i r o m s k ee m
protože	p r o t o zh e
provozují	p r o v o z u j ii
prozradil	p r o z r a dj i l
proč	p r o ch
první	p r v nj ii
prvních	p r v nj ii x
prvním	p r v nj ii m
práce	p r aa c e
práci	p r aa c i
práv	p r aa f
právní	p r aa v nj ii
právě	p r aa v j e
prý	p r ii
průběh	p r uu b j e x
průběhem	p r uu b j e h e m
ptala	p t a l a
ptali	p t a l i
ptám	p t aa m
ptáme	p t aa m e
publika	p u b l i k a
publikovaného	p u b l i k o v a n ee h o
pár	p aa r
párem	p aa r e m
páry	p aa r i
pátek	p aa t e k
pěstování	p j e s t o v aa nj ii
pět	p j e t
přebytkem	p rsh e b i t k e m
přechodu	p rsh e x o d u
před	p rsh e d
předchozím	p rsh e d x o z ii m
předcházela	p rsh e d x aa z e l a
předepsány	p rsh e d e p s aa n i
předpisů	p rsh e d p i s uu
předseda	p rsh e d s e d a
předsedkyně	p rsh e d s e t k i nj e
představeno	p rsh e d s t a v e n o
představila	p rsh e d s t a v i l a
představili	p rsh e d s t a v i l i
představí	p rsh e d s t a v ii
předvedla	p rsh e d v e d l a
předvolební	p rsh e d v o l e b nj ii
předvídat	p rsh e d v ii d a t
předávání	p rsh e d aa v aa nj ii
přehledem	p rsh e h l e d e m
přehnané	p rsh e h n a n ee
přehradě	p rsh e h r a dj e
překonat	p rsh e k o n a t
překvapení	p rsh e k v a p e nj ii
překvapivě	p rsh e k v a p i v j e
přemožitelkami	p rsh e m o zh i t e l k a m i
přes	p rsh e s
přesto	p rsh e s t o
přestože	p rsh e s t o zh e
přetrvávala	p rsh e t r v aa v a l a
při	p rsh i
přichází	p rsh i x aa z ii
přidělanými	p rsh i dj e l a n ii m i
přijala	p rsh i j a l a
přijela	p rsh i j e l a
přijeli	p rsh i j e l i
přikročilo	p rsh i k r o ch i l o
přikročit	p rsh i k r o ch i t
přiměly	p rsh i m nj e l i
přinesla	p rsh i n e s l a
připomněli	p rsh i p o m nj e l i
připomíná	p rsh i p o m ii n aa
připraven	p rsh i p r a v e n
připravený	p rsh i p r a v e n ii
připravila	p rsh i p r a v i l a
připravit	p rsh i p r a v i t
připravoval	p rsh i p r a v o v a l
přispění	p rsh i s p j e nj ii
přišla	p rsh i sh l a
přátel	p rsh aa t e l
přátelská	p rsh aa t e l s k aa
příchozí	p rsh ii x o z ii
příležitosti	p rsh ii l e zh i t o s tj i
přínos	p rsh ii n o s
případu	p rsh ii p a d u
případů	p rsh ii p a d uu
přírodní	p rsh ii r o d nj ii
přírodním	p rsh ii r o d nj ii m
přírodními	p rsh ii r o d nj ii m i
přírodu	p rsh ii r o d u
přístrojů	p rsh ii s t r o j uu
příušnicím	p rsh ii u sh nj i c ii m
příčce	p rsh ii ch c e
půjčovaly	p uu j ch o v a l i
půlroční	p uu l r o ch nj ii
působí	p uu s o b ii
původem	p uu v o d e m
původní	p uu v o d nj ii
původních	p uu v o d nj ii x
původně	p uu v o d nj e
queenslandská	k v ii n s l a n t s k aa
queenslandu	k v ii n s l a n d u
rada	r a d a
radní	r a d nj ii
radost	r a d o s t
rady	r a d i
raději	r a dj e j i
rafaela	r a f a e l a
raketově	r a k e t o v j e
rakovinou	r a k o v i n ow
rasistickém	r a s i s t i c k ee m
reagoval	r e a g o v a l
reaguje	r e a g u j e
reakce	r e a k c e
reakci	r e a k c i
recepce	r e c e p c e
recital	r e c i t a l
recyklovaná	r e c i k l o v a n aa
regionálních	r e g i j o n aa l nj ii x
rekordní	r e k o r d nj ii
rekordních	r e k o r d nj ii x
reportérka	r e p o r t ee r k a
reprezentační	r e p r e z e n t a ch nj ii
republikou	r e p u b l i k ow
republiky	r e p u b l i k i
republikán	r e p u b l i k aa n
republikánské	r e p u b l i k aa n s k ee
reputace	r e p u t a c e
respektem	r e s p e k t e m
restaurace	r e s t aw r a c e
restauraci	r e s t aw r a c i
restaurované	r e s t aw r o v a n ee
revizi	r e v i z i
režii	r e zh i j i
richardson	r i x a r t s n
river	r i v e r
riziko	r i z i k o
rizikovými	r i z i k o v ii m i
roce	r o c e
rocker	r o k e r
rod	r o t
rodačka	r o d a ch k a
rodiny	r o dj i n i
rok	r o k
roku	r o k u
roky	r o k i
role	r o l e
roli	r o l i
roste	r o s t e
rostliny	r o s t l i n i
rostlinách	r o s t l i n aa x
rostou	r o s t ow
rostoucí	r o s t ow c ii
rozdělovány	r o z dj e l o v aa n i
rozebírá	r o z e b ii r aa
rozhlasová	r o z h l a s o v aa
rozhodilo	r o z h o dj i l o
rozhodli	r o z h o d l i
rozhodnutí	r o z h o d n u tj ii
rozhovor	r o z h o v o r
rozhovoru	r o z h o v o r u
rozpočet	r o z p o ch e t
rozsvítí	r o z s v ii tj ii
rozvážející	r o z v aa zh e j ii c ii
rozšířeného	r o z sh ii rzh e n ee h o
rozšíří	r o z sh ii rzh ii
ročního	r o ch nj ii h o
ročně	r o ch nj e
ruchu	r u x u
rukou	r u k ow
ruky	r u k i
ruska	r u s k a
ruskem	r u s k e m
rusku	r u s k u
ryb	r i p
ráda	r aa d a
rámci	r aa m c i
rána	r aa n a
rány	r aa n i
růstu	r uu s t u
různými	r uu z n ii m i
s	s
salmonela	s a l m o n e l a
sama	s a m a
samanthou	s a m a n d h ow
samanthu	s a m a n d h u
sami	s a m i
samozřejmě	s a m o z rzh e j m nj e
sanchez	e s e n ch e s
sbs	z b s
sbírá	z b ii r aa
schooling	sh uu l i ng k
schůzce	s x uu s c e
schůzi	s x uu z i
schůzka	s x uu s k a
scott	s k o t
scottu	s k o t u
scénáři	s c ee n aa rzh i
sděluje	z dj e l u j e
se	s e
sebou	s e b ow
sedmkrát	s e d m k r aa t
semifinále	s e m i f i n aa l e
semifinálových	s e m i f i n aa l o v ii x
sentimentu	s e nj t i m e n t u
senátor	s e n aa t o r
senátu	s e n aa t u
serena	s e r e n a
serenou	s e r e n ow
serenu	s e r e n u
servíruje	s e r v ii r u j e
set	s e t
setech	s e t e x
setkala	s e t k a l a
setkání	s e t k aa nj ii
setkáváme	s e t k aa v aa m e
setrvává	s e t r v aa v aa
setu	s e t u
severní	s e v e r nj ii
sexualitu	s e k s u a l i t u
sexuální	s e k s u aa l nj ii
seznam	s e z n a m
sezóna	s e z oo n a
sešel	s e sh e l
sharapovou	sh e r a p o v ow
shledání	z h l e d aa nj ii
shorten	sh o r t e n
show	sh ow
shrnu	z h r n u
si	s i
sice	s i c e
silnou	s i l n ow
silná	s i l n aa
simonu	s i m o n u
siniaková	s i n i j a k o v aa
situace	s i t u a c e
situaci	s i t u a c i
skandálu	s k a n d aa l u
skladeb	s k l a d e p
skončil	s k o n ch i l
skončila	s k o n ch i l a
skončilo	s k o n ch i l o
skoro	s k o r o
skotu	s k o t u
skrz	s k r z
skupina	s k u p i n a
skupinu	s k u p i n u
skupiny	s k u p i n i
skupině	s k u p i nj e
skutečnosti	s k u t e ch n o s tj i
skutečným	s k u t e ch n ii m
skutečně	s k u t e ch nj e
skvělý	s k v j e l ii
slavnostní	s l a v n o s t nj ii
slavnostního	s l a v n o s t nj ii h o
slavnostním	s l a v n o s t nj ii m
slavnostně	s l a v n o s t nj e
slavík	s l a v ii k
sledoval	s l e d o v a l
sledovanost	s l e d o v a n o s t
slibně	s l i b nj e
slibuje	s l i b u j e
slo	s l o
slova	s l o v a
slovenska	s l o v e n s k a
slovensko	s l o v e n s k o
slovenských	s l o v e n s k ii x
slovy	s l o v i
slováka	s l o v aa k a
slováků	s l o v aa k uu
složila	s l o zh i l a
složit	s l o zh i t
sluchu	s l u x u
sluchátek	s l u x aa t e k
sluníčkem	s l u nj ii ch k e m
slušné	s l u sh n ee
služby	s l u zh b i
službách	s l u zh b aa x
služeb	s l u zh e p
smetánky	s m e t aa ng k i
smrtelném	s m r t e l n ee m
smutnila	s m u t nj i l a
smyčku	s m i ch k u
směřovali	s m nj e rzh o v a l i
směřuje	s m nj e rzh u j e
snad	s n a t
snaze	s n a z e
snižování	s nj i zh o v aa nj ii
snížení	s nj ii zh e nj ii
sobotu	s o b o t u
sokole	s o k o l e
soli	s o l i
soupeřkou	s ow p e rsh k ow
soupeřku	s ow p e rsh k u
soupeřky	s ow p e rsh k i
sousta	s ow s t a
souvislost	s ow v i s l o s t
souvislosti	s ow v i s l o s tj i
současnosti	s ow ch a s n o s tj i
současné	s ow ch a s n ee
součást	s ow ch aa s t
spalničkám	s p a l nj i ch k aa m
specialisté	s p e c i j a l i s t ee
speciální	s p e c i j aa l nj ii
splaskne	s p l a s k n e
splácet	s p l aa c e t
spokojena	s p o k o j e n a
společenstva	s p o l e ch e n s t v a
společnostem	s p o l e ch n o s t e m
společnosti	s p o l e ch n o s tj i
společností	s p o l e ch n o s tj ii
společný	s p o l e ch n ii
spolu	s p o l u
spolupracovali	s p o l u p r a c o v a l i
spontánních	s p o n t aa nj ii x
sportovci	s p o r t o f c i
sportovkyně	s p o r t o f k i nj e
sportu	s p o r t u
spotřebitelský	s p o t rsh e b i t e l s k ii
spravedlnosti	s p r a v e d l n o s tj i
spravovány	s p r a v o v aa n i
spuštěna	s p u sh tj e n a
spuštění	s p u sh tj e nj ii
spálená	s p aa l e n aa
spálení	s p aa l e nj ii
sta	s t a
stabilní	s t a b i l nj ii
stal	s t a l
stala	s t a l a
staletí	s t a l e tj ii
stanice	s t a nj i c e
stanislava	s t a nj i s l a v a
stanovily	s t a n o v i l i
starobová	s t a r o b o v aa
startuje	s t a r t u j e
starý	s t a r ii
starší	s t a r sh ii
statistik	s t a t i s t i k
statistiky	s t a t i s t i k i
stav	s t a f
stavu	s t a v u
staví	s t a v ii
stejného	s t e j n ee h o
stejně	s t e j nj e
stojanů	s t o j a n uu
stolu	s t o l u
stosur	s t o s u r
stovky	s t o f k i
strach	s t r a x
stranou	s t r a n ow
stranu	s t r a n u
strany	s t r a n i
strategie	s t r a t e g i j e
stravu	s t r a v u
street	s t r ii t
strávil	s t r aa v i l
strýcová	s t r ii c o v aa
student	s t u d e n t
studenti	s t u d e n tj i
studenty	s t u d e n t i
studentů	s t u d e n t uu
studie	s t u d i j e
studium	s t u d i j u m
studovala	s t u d o v a l a
studovat	s t u d o v a t
studující	s t u d u j ii c ii
styl	s t i l
stáhli	s t aa h l i
stále	s t aa l e
stát	s t aa t
státní	s t aa t nj ii
státníků	s t aa t nj ii k uu
států	s t aa t uu
stává	s t aa v aa
sté	s t ee
stěžují	s tj e zh u j ii
stěží	s tj e zh ii
středeční	s t rsh e d e ch nj ii
střední	s t rsh e d nj ii
středních	s t rsh e d nj ii x
středomořskou	s t rsh e d o m o rsh s k ow
středu	s t rsh e d u
střet	s t rsh e t
střílející	s t rsh ii l e j ii c ii
střílení	s t rsh ii l e nj ii
sucha	s u x a
suchem	s u x e m
sucho	s u x o
summit	s a m i t
superanuace	s u p e r a n u a c e
superanuaci	s u p e r a n u a c i
suverénně	s u v e r ee nj e
svazů	s v a z uu
svobody	s v o b o d i
svobodách	s v o b o d aa x
svoji	s v o j i
svolal	s v o l a l
svolala	s v o l a l a
svou	s v ow
svržení	s v r zh e nj ii
své	s v ee
svého	s v ee h o
svém	s v ee m
svému	s v ee m u
svých	s v ii x
svědomí	s v j e d o m ii
svět	s v j e t
světa	s v j e t a
světem	s v j e t e m
světovou	s v j e t o v ow
světová	s v j e t o v aa
světové	s v j e t o v ee
světového	s v j e t o v ee h o
světovém	s v j e t o v ee m
světový	s v j e t o v ii
světě	s v j e tj e
svěřil	s v j e rzh i l
svůj	s v uu j
sydney	s i d n i
sydneyské	s i d n i s k ee
syn	s i n
systému	s i s t ee m u
sídlo	s ii d l o
sólo	e s oo l o
ta	t a
tady	t a d i
tajných	t a j n ii x
tak	t a k
takhle	t a g h l e
takto	t a k t o
takzvané	t a g z v a n ee
takzvaně	t a g z v a nj e
také	t a k ee
takže	t a g zh e
talentovanější	t a l e n t o v a nj e j sh ii
tam	t a m
tato	t a t o
tebou	t e b ow
technologií	t e x n o l o g i j ii
tedy	t e d i
tehdy	t e h d i
telefonů	t e l e f o n uu
tematikou	t e m a t i k ow
ten	t e n
tenis	t e n i s
tenise	t e nj i s e
tenisovou	t e nj i s o v ow
tenisové	t e nj i s o v ee
tenistce	t e nj i s t c e
tenistky	t e nj i s t k i
tento	t e n t o
tentokrát	t e n t o k r aa t
teplota	t e p l o t a
teploty	t e p l o t i
teprve	t e p r v e
teritorií	t e r i t o r i j ii
terorismu	t e r o r i z m u
teroristu	t e r o r i s t u
teď	t e tj
ti	tj i
tie	t i j e
tipaři	tj i p a rzh i
tisková	tj i s k o v aa
tiskové	tj i s k o v ee
tisíc	tj i s ii c
tisíciletí	tj i s ii c i l e tj ii
to	t o
tohle	t o h l e
toho	t o h o
tohoto	t o h o t o
tolik	t o l i k
tom	t o m
tombole	t o m b o l e
tomto	t o m t o
tomu	t o m u
tomuto	t o m u t o
tomáš	t o m aa sh
tomáše	t o m aa sh e
tomášem	t o m aa sh e m
top	t o p
totiž	t o tj i sh
toto	t o t o
tragického	t r a g i c k ee h o
trenér	t r e n ee r
trhy	t r h i
trikolory	t r i k o l o r i
trip	t r i p
trochu	t r o x u
trofej	t r o f e j
trofejí	t r o f e j ii
trošku	t r o sh k u
trpícím	t r p ii c ii m
trump	t r u m p
trumpa	t r u m p a
trvající	t r v a j ii c ii
trvalou	t r v a l ow
trvalému	t r v a l ee m u
trvá	t r v aa
tréninku	t r ee n i ng k u
turisti	t u r i s tj i
turisty	t u r i s t i
turnaj	t u r n a j
turnaje	t u r n a j e
turnaji	t u r n a j i
turnbull	t u r n b u l
turnbullem	t u r n b u l e m
tv	t ee v ee
tvrdí	t v r dj ii
tvrdší	t v r t sh ii
ty	t i
typický	t i p i c k ii
tzv	t z v
táhnoucí	t aa h n ow c ii
téma	t ee m a
téměř	t ee m nj e rsh
této	t ee t o
tím	tj ii m
týden	t ii d e n
týdne	t ii d n e
týdny	t ii d n i
týmu	t ii m u
těch	tj e x
těchto	tj e x t o
těšit	tj e sh i t
těžké	tj e sh k ee
třeba	t rsh e b a
třech	t rsh e x
třemi	t rsh e m i
třetina	t rsh e tj i n a
třetiny	t rsh e tj i n i
třetím	t rsh e tj ii m
tři	t rsh i
třpytek	t rsh p i t e k
třípokojovém	t rsh ii p o k o j o v ee m
u	u
ubytování	u b i t o v aa nj ii
uchovat	u x o v a t
uctění	u c tj e nj ii
udržela	u d r zh e l a
udržitelnost	u d r zh i t e l n o s t
udělala	u dj e l a l a
udělení	u dj e l e nj ii
udělování	u dj e l o v aa nj ii
uhynul	u h i n u l
ukazováček	u k a z o v aa ch e k
uklidnili	u k l i d nj i l i
ukončení	u k o n ch e nj ii
ukončili	u k o n ch i l i
ukončit	u k o n ch i t
ukončí	u k o n ch ii
ukradená	u k r a d e n aa
ukrajinou	u k r a j i n ow
ukrajiny	u k r a j i n i
ukráceni	u k r aa c e nj i
ukázka	u k aa s k a
ulevit	u l e v i t
ulic	u l i c
unii	u n i j i
unikátní	u n i k aa t nj ii
univerzita	u n i v e r z i t a
univerzitách	u n i v e r z i t aa x
univerzitě	u n i v e r z i tj e
upřímně	u p rsh ii m nj e
us	u s
usa	u e s aa
utkají	u t k a j ii
utkaly	u t k a l i
utká	u t k aa
utonutí	u t o n u tj ii
utopilo	u t o p i l o
utratili	u t r a tj i l i
utrácejí	u t r aa c e j ii
uvádí	u v aa dj ii
uváčiková	u v aa ch i k o v aa
uvítala	u v ii t a l a
uvítaly	u v ii t a l i
uzákoněn	u z aa k o nj e n
učení	u ch e nj ii
už	u sh
užití	u zh i tj ii
užívá	u zh ii v aa
v	f
vaclav	v a c l a f
vakcínou	v a k c ii n ow
varovně	v a r o v nj e
varování	v a r o v aa nj ii
varují	v a r u j ii
vazby	v a z b i
ve	v e
vede	v e d e
veder	v e d e r
vedla	v e d l a
vedlo	v e d l o
vedry	v e d r i
velezkušená	v e l e s k u sh e n aa
velkou	v e l k ow
velká	v e l k aa
velké	v e l k ee
velký	v e l k ii
velkých	v e l k ii x
velkým	v e l k ii m
velmi	v e l m i
velrybářství	v e l r i b aa rsh s t v ii
velvyslance	v e l v i s l a n c e
venkovských	v e ng k o f s k ii x
vepřo	v e p rsh o
večera	v e ch e r a
veřejnost	v e rzh e j n o s t
veřejnosti	v e rzh e j n o s tj i
veřejnými	v e rzh e j n ii m i
veškeré	v e sh k e r ee
veškerého	v e sh k e r ee h o
viktorie	v i k t o r i j e
vintr	v i n t r
viní	v i nj ii
visí	v i s ii
vlastní	v l a s t nj ii
vlastou	v l a s t ow
vlny	v l n i
vláda	v l aa d a
vládu	v l aa d u
vlády	v l aa d i
vládě	v l aa dj e
vláhy	v l aa h i
vnitra	v nj i t r a
vnímají	v nj ii m a j ii
voda	v o d a
vodním	v o d nj ii m
vody	v o d i
vodě	v o dj e
volba	v o l b a
volby	v o l b i
volbách	v o l b aa x
volbám	v o l b aa m
voleb	v o l e p
volejů	v o l e j uu
volit	v o l i t
volí	v o l ii
vondroušová	v o n d r ow sh o v aa
vozidel	v o z i d e l
vracet	v r a c e t
vrah	v r a x
vratnou	v r a t n ow
vraždou	v r a zh d ow
vrcholícím	v r x o l ii c ii m
vrátit	v r aa tj i t
vybírat	v i b ii r a t
vydaly	v i d a l i
vydává	v i d aa v aa
vyhlašovacím	v i h l a sh o v a c ii m
vyhrožuje	v i h r o zh u j e
vyhrála	v i h r aa l a
vyhrát	v i h r aa t
vyhynutím	v i h i n u tj ii m
vyjel	v i j e l
vykořisťování	v i k o rzh i s tj o v aa nj ii
vyloučen	v i l ow ch e n
vylučuje	v i l u ch u j e
vymírání	v i m ii r aa nj ii
vymřít	v i m rzh ii t
vynesly	v i n e s l i
vypadalo	v i p a d a l o
vypadat	v i p a d a t
vyplatily	v i p l a tj i l i
vyplývá	v i p l ii v aa
vypracování	v i p r a c o v aa nj ii
vypravme	v i p r a v m e
vypátrali	v i p aa t r a l i
vyrovnán	v i r o v n aa n
vyskytující	v i s k i t u j ii c ii
vyslovil	v i s l o v i l
vyslovila	v i s l o v i l a
vysoké	v i s o k ee
vystoupení	v i s t ow p e nj ii
vystoupil	v i s t ow p i l
vystřelila	v i s t rsh e l i l a
vysvětlují	v i s v j e t l u j ii
vysílali	v i s ii l a l i
vysílání	v i s ii l aa nj ii
vytváří	v i t v aa rzh ii
využít	v i u zh ii t
vyvolalo	v i v o l a l o
vyvolávají	v i v o l aa v a j ii
vyzvat	v i z v a t
vyzve	v i z v e
vyzývají	v i z ii v a j ii
vyzývá	v i z ii v aa
vyzýváno	v i z ii v aa n o
vyčišťování	v i ch i sh tj o v aa nj ii
vyřadila	v i rzh a dj i l a
vyšetřování	v i sh e t rsh o v aa nj ii
vyšší	v i sh ii
vyžaduje	v i zh a d u j e
vzala	v z a l a
vzdaly	v z d a l i
vzdálenosti	v z d aa l e n o s tj i
vzdálených	v z d aa l e n ii x
vzdělání	v z dj e l aa nj ii
vzdělávání	v z dj e l aa v aa nj ii
vzhledem	v z h l e d e m
vzrostlo	v z r o s t l o
vzrůstající	v z r uu s t a j ii c ii
vzájemném	v z aa j e m n ee m
vzájemných	v z aa j e m n ii x
václav	v aa c l a f
války	v aa l k i
vás	v aa s
vážnou	v aa zh n ow
vážné	v aa zh n ee
vážným	v aa zh n ii m
vážně	v aa zh nj e
vést	v ee s t
vévodkyně	v ee v o t k i nj e
ví	v ii
víc	v ii c
více	v ii c e
víkend	v ii k e n t
vím	v ii m
vítr	v ii t r
vítězce	v ii tj e s c e
vítězka	v ii tj e s k a
vítězkou	v ii tj e s k ow
vítězně	v ii tj e z nj e
vítězstvím	v ii tj e s t v ii m
vítězí	v ii tj e z ii
víza	v ii z a
výborné	v ii b o r n ee
výbušnými	v ii b u sh n ii m i
východisko	v ii x o d i s k o
východní	v ii x o d nj ii
východního	v ii x o d nj ii h o
výdaje	v ii d a j e
výhře	v ii h rzh e
výměn	v ii m nj e n
výpovědi	v ii p o v j e dj i
výrobci	v ii r o p c i
výroční	v ii r o ch nj ii
výročí	v ii r o ch ii
výskytu	v ii s k i t u
výsledkem	v ii s l e t k e m
výstava	v ii s t a v a
vývoj	v ii v o j
vývoji	v ii v o j i
výzkumné	v ii s k u m n ee
výzkumníci	v ii s k u m nj ii c i
výzva	v ii z v a
výzvy	v ii z v i
včerejším	f ch e r e j sh ii m
věc	v j e c
vědci	v j e t c i
vědecká	v j e d e c k aa
vědecký	v j e d e c k ii
vědomím	v j e d o m ii m
vědě	v j e dj e
věděla	v j e dj e l a
věrohodností	v j e r o h o d n o s tj ii
větrném	v j e t r n ee m
většina	v j e t sh i n a
větší	v j e t sh ii
vězí	v j e z ii
však	f sh a k
vše	f sh e
všechny	f sh e x n i
všem	f sh e m
vším	f sh ii m
vždy	v zh d i
walesu	v a l e s u
washingtonu	v o sh i ng k t n u
whitsundays	v h i t s u n d e j s
who	v h o
williams	v i l i j e m s
wimbledonu	v i m b l e d o n u
world	v o r l t
wta	f t a
z	s
za	z a
zabaví	z a b a v ii
zabránit	z a b r aa nj i t
zabíjela	z a b ii j e l a
zachováním	z a x o v aa nj ii m
zadržené	z a d r zh e n ee
zahraniční	z a h r a nj i ch nj ii
zahraničním	z a h r a nj i ch nj ii m
zahraničí	z a h r a nj i ch ii
zahrál	z a h r aa l
zahrála	z a h r aa l a
zahájen	z a h aa j e n
zahájení	z a h aa j e nj ii
zajistili	z a j i s tj i l i
zajímají	z a j ii m a j ii
zajímavý	z a j ii m a v ii
zakotvily	z a k o t v i l i
zakousl	z a k ow s l
zakázkové	z a k aa s k o v ee
založená	z a l o zh e n aa
založení	z a l o zh e nj ii
zaměstnance	z a m nj e s t n a n c e
zaměstnání	z a m nj e s t n aa nj ii
zaměřený	z a m nj e rzh e n ii
zaměřují	z a m nj e rzh u j ii
zanedlouho	z a n e d l ow h o
zanzibar	z a n z i b a r
zapomněla	z a p o m nj e l a
zarděnkám	z a r dj e ng k aa m
zasažena	z a s a zh e n a
zasažených	z a s a zh e n ii x
zastavení	z a s t a v e nj ii
zastupitelstev	z a s t u p i t e l s t e f
zastánci	z a s t aa n c i
zato	z a t o
zatím	z a tj ii m
zatímco	z a tj ii m c o
zatčený	z a t ch e n ii
zaujala	z aw j a l a
zaveden	z a v e d e n
zazněly	z a z nj e l i
začal	z a ch a l
začala	z a ch a l a
začátku	z a ch aa t k u
začínají	z a ch ii n a j ii
začít	z a ch ii t
zařízení	z a rzh ii z e nj ii
zařízeními	z a rzh ii z e nj ii m i
zažili	z a zh i l i
zbavuje	z b a v u j e
zbyněk	z b i nj e k
zda	z d a
zde	z d e
zdecimovaných	z d e c i m o v a n ii x
zdravotnická	z d r a v o t nj i c k aa
zdravotnictví	z d r a v o t nj i c t v ii
zdraví	z d r a v ii
zdravý	z d r a v ii
zdroj	z d r o j
zdroje	z d r o j e
zdvihá	z d v i h aa
zdvojnásobení	z d v o j n aa s o b e nj ii
zdvojnásobila	z d v o j n aa s o b i l a
zdá	z d aa
zdání	z d aa nj ii
ze	z e
zeleniny	z e l e nj i n i
zeleného	z e l e n ee h o
zelený	z e l e n ii
zelo	z e l o
zemi	z e m i
zemí	z e m ii
zemích	z e m ii x
země	z e m nj e
zemědělský	z e m nj e dj e l s k ii
zhoršující	z h o r sh u j ii c ii
zjistila	z j i s tj i l a
zjištění	z j i sh tj e nj ii
zkoumá	s k ow m aa
zkoumáních	s k ow m aa nj ii x
zkouší	s k ow sh ii
zkrátka	s k r aa t k a
zkulturňování	s k u l t u r nj o v aa nj ii
zkusí	s k u s ii
zkušenosti	s k u sh e n o s tj i
zlatý	z l a t ii
zlepšení	z l e p sh e nj ii
zlikvidována	z l i k v i d o v aa n a
změnami	z m nj e n a m i
změnou	z m nj e n ow
změnu	z m nj e n u
změny	z m nj e n i
změnám	z m nj e n aa m
znalostí	z n a l o s tj ii
znamená	z n a m e n aa
značek	z n a ch e k
značky	z n a ch k i
zneužívání	z n ew zh ii v aa nj ii
zná	z n aa
znám	z n aa m
zpravodajců	s p r a v o d a j c uu
zpravodajské	s p r a v o d a j s k ee
zpráva	s p r aa v a
zprávy	s p r aa v i
zpět	s p j e t
způsob	s p uu s o p
způsobené	s p uu s o b e n ee
způsobeného	s p uu s o b e n ee h o
zrušena	z r u sh e n a
zrušení	z r u sh e nj ii
zte	s t e
ztráta	s t r aa t a
ztrátu	s t r aa t u
ztráty	s t r aa t i
ztrátám	s t r aa t aa m
zuzana	z u z a n a
zve	z v e
zveřejňuje	z v e rzh e j nj u j e
zvládat	z v l aa d a t
zvláštní	z v l aa sh t nj ii
zvláštně	z v l aa sh t nj e
zvolilo	z v o l i l o
zvraty	z v r a t i
zvrátit	z v r aa tj i t
zvyšující	z v i sh u j ii c ii
zvážit	z v aa zh i t
zvítězila	z v ii tj e z i l a
zvířat	z v ii rzh a t
zvířata	z v ii rzh a t a
zvýšily	z v ii sh i l i
zájem	z aa j e m
zájmu	z aa j m u
zájmů	z aa j m uu
zákaz	z aa k a s
zákazník	z aa k a z nj ii k
zákazníky	z aa k a z nj ii k i
zákazu	z aa k a z u
základnu	z aa k l a d n u
základě	z aa k l a dj e
zákon	z aa k o n
záležitost	z aa l e zh i t o s t
zálohou	z aa l o h ow
zámoří	z aa m o rzh ii
západního	z aa p a d nj ii h o
zápas	z aa p a s
zápase	z aa p a s e
zápasech	z aa p a s e x
zápasu	z aa p a s u
zápasy	z aa p a s i
zápasů	z aa p a s uu
zároveň	z aa r o v e nj
zásadní	z aa s a d nj ii
zásadních	z aa s a d nj ii x
zásobování	z aa s o b o v aa nj ii
zástupců	z aa s t u p c uu
závažnější	z aa v a zh nj e j sh ii
závisejí	z aa v i s e j ii
záznam	z aa z n a m
záznamu	z aa z n a m u
záznamů	z aa z n a m uu
září	z aa rzh ii
zážitky	z aa zh i t k i
zéland	z ee l a n t
zélandu	z ee l e n d u
získat	z ii s k a t
zítra	z ii t r a
zřejmě	z rzh e j m nj e
zůstanou	z uu s t a n ow
zůstávali	z uu s t aa v a l i
údajně	uu d a j nj e
úložiště	uu l o zh i sh tj e
úroveň	uu r o v e nj
úsměvem	uu s m nj e v e m
úspory	uu s p o r i
úspěchem	uu s p j e x e m
ústavní	uu s t a v nj ii
útokem	uu t o k e m
útoku	uu t o k u
útoky	uu t o k i
útoků	uu t o k uu
útočníkem	uu t o ch nj ii k e m
účtech	uu ch t e x
úřadování	uu rzh a d o v aa nj ii
úřadu	uu rzh a d u
úřadě	uu rzh a dj e
úřadům	uu rzh a d uu m
úředníci	uu rzh e d nj ii c i
úžasný	uu zh a s n ii
čaj	ch a j
čaje	ch a j e
čang	ch a ng k
čaputová	ch a p u t o v aa
čapí	ch a p ii
čas	ch a s
často	ch a s t o
častěji	ch a s tj e j i
častější	ch a s tj e j sh ii
času	ch a s u
časy	ch a s i
čech	ch e x
čecho	ch e x o
čechů	ch e x uu
čekací	ch e k a c ii
čekají	ch e k a j ii
čekat	ch e k a t
čeká	ch e k aa
čelí	ch e l ii
čem	ch e m
čerpali	ch e r p a l i
čerpání	ch e r p aa nj ii
čerstvě	ch e r s t v j e
červeného	ch e r v e n ee h o
červený	ch e r v e n ii
červnem	ch e r v n e m
česka	ch e s k a
česko	ch e s k o
československa	ch e s k o s l o v e n s k a
československé	ch e s k o s l o v e n s k ee
českou	ch e s k ow
česku	ch e s k u
česká	ch e s k aa
české	ch e s k ee
českého	ch e s k ee h o
českém	ch e s k ee m
český	ch e s k ii
českých	ch e s k ii x
českým	ch e s k ii m
českými	ch e s k ii m i
čest	ch e s t
češi	ch e sh i
češka	ch e sh k a
či	ch i
čichá	ch i x aa
čin	ch i n
činnosti	ch i n o s tj i
činu	ch i n u
člena	ch l e n a
člověku	ch l o v j e k u
čopy	ch o p i
čsr	ch s r
čtvrt	ch t v r t
čtvrtfinále	ch t v r t f i n aa l e
čtvrtém	ch t v r t ee m
čtvrť	ch t v r tj
čtyř	ch t i rsh
čtyři	ch t i rzh i
část	ch aa s t
části	ch aa s tj i
částí	ch aa s tj ii
čínsko	ch ii n s k o
čínských	ch ii n s k ii x
číny	ch ii n i
řad	rzh a t
řada	rzh a d a
řadou	rzh a d ow
ředitelkou	rzh e dj i t e l k ow
řekl	rzh e k l
řekla	rzh e k l a
řeky	rzh e k i
řeč	rzh e ch
řešení	rzh e sh e nj ii
řešili	rzh e sh i l i
řádu	rzh aa d u
říct	rzh ii c t
října	rzh ii j n a
říkají	rzh ii k a j ii
říká	rzh ii k aa
šampionku	sh a m p i o ng k u
šance	sh a n c e
šanci	sh a n c i
šestá	sh e s t aa
šestému	sh e s t ee m u
širokou	sh i r o k ow
škodlivé	sh k o d l i v ee
škol	sh k o l
škole	sh k o l e
školu	sh k o l u
školy	sh k o l i
školách	sh k o l aa x
školícího	sh k o l ii c ii h o
škorpióni	sh k o r p i j oo nj i
šli	sh l i
šneci	sh n e c i
šoku	sh o k u
španěla	sh p a nj e l a
španělce	sh p a nj e l c e
španělku	sh p a nj e l k u
špatném	sh p a t n ee m
špatně	sh p a t nj e
štefan	sh t e f a n
štefana	sh t e f a n a
štěfan	sh tj e f a n
štěpánka	sh tj e p aa ng k a
štěstí	sh tj e s tj ii
šuaj	sh u a j
šárka	sh aa r k a
žalobu	zh a l o b u
že	zh e
žebříčku	zh e b rzh ii ch k u
žen	zh e n
ženském	zh e n s k ee m
ženu	zh e n u
ženy	zh e n i
ženách	zh e n aa x
žije	zh i j e
žijí	zh i j ii
žijící	zh i j ii c ii
života	zh i v o t a
životech	zh i v o t e x
životní	zh i v o t nj ii
životě	zh i v o tj e
živá	zh i v aa
živé	zh i v ee
žraloka	zh r a l o k a
žraloků	zh r a l o k uu
žraločí	zh r a l o ch ii
žádající	zh aa d a j ii c ii
žádná	zh aa d n aa
žádné	zh aa d n ee
žádný	zh aa d n ii
žádostem	zh aa d o s t e m
