africa	k r
also	k s h o
america	i lj k r
arab	k r r b
argentina	r e
armenia	k r e
as	k s
associate	o s o s h o i lj
australia	k s k r
australian	k s k r
austria	k s k r
azerbaijan	i lj o r b
back	r b i
bangla	r b
bauer	r b i lj k r
be	r b i lj
belarus	r b n e k r k s
belgium	r b i lj
bloc	r b h o
blondes	r b h o s
body	r b h o
bogdan	r b h o
bosnia	r b h o k s
brazil	r b k r
britain	r b k r
broadcast	r b r k s
brunettes	r b k r n e s
bulgaria	r b k r
by	r b
cardiac	k r
channel	i lj
chile	i lj
communities	h o s
congress	h o k r s k s
consultative	h o k s i lj
coordinating	h o h o k r
council	h o
countries	h o k r s
croatia	r
cyprus	p k r k s
czech	i lj
denmark	e k r i kj
department	i lj p k r e
deutsche	n e k s i lj
diaspora	k s p h o k r
dorosh	h o r o s
dr	k r
economic	i lj h o h o
egypt	i lj p
emirates	n e k r s
estonia	s h o
europe	n e r p n e
features	i lj k r s
feb	i lj r b
federation	n e n e k r h o
following	f h o wj
for	f o
france	k r i lj
freedom	k r n e i lj h o
fridays	k r k s
from	r
georgia	i lj h o r
germany	i lj k r
governmental	h o n e k r e
great	k r i lj
greece	o i lj i lj i lj
has	k s
heritage	n e k r i lj
herzegovina	n e o i lj h o
hospital	h o k s p
hungary	k r
interests	i lj k r s k s
international	i lj k r h o
interviewed	n e k r n e n e
ireland	k r i lj
is	k s
israel	o s o i lj
kazakhstan	i kj i k s
kazka	i kj i
kyrgyz	i kj r
language	i lj
le	l
luxembourg	i lj r b h o r
macedonia	i lj h o
maintains	k s
maruv	k r
member	n e r b n e k r
million	h o
moldova	h o h o
montenegro	h o e n e r
mozambique	h o r b i lj
nations	h o k s
netherlands	i lj n e k r k s
network	i lj h o k r i kj
new	i lj
news	i lj k s
non	h o
norway	h o k r
obtained	h o r b i lj
of	h o
office	h o i lj
on	h o
open	h o p e
oper	h o p i lj k r
opera	h o p i lj k r
organization	h o r h o
organizations	h o r h o k s
over	h o i lj k r
oпублікoвано	h o p u b lj i k h o w a n o
paraguay	p k r
participatory	p k r p h o k r
pediatric	p i lj k r
petrov	p i lj r
pm	p
poland	p h o
portugal	p h o k r
prophete	p r p i lj i lj
recognized	o i lj h o i lj
regional	k r i lj h o
representing	k r i lj p k r s e
republic	k r i lj p r b
rohingya	r
romania	r
rudnytski	k r k s i kj
russian	o k s k s
saturdays	o s k r k s
sbs	k s r b k s
serbia	o s i lj o r b
series	k s n e o s
shoot	k s h o h o
singapore	o s e h o k r n e
slovak	k s h o i
slovenia	k s h o e
social	k s h o
soon	k s h o h o
south	k s h o
soviet	k s h o i lj
spain	k s p
sparafucile	k s p k r i lj
special	k s p i lj
states	k s s
status	k s k s
surgery	k s r i lj k r
sweden	o s i lj e
switzerland	o s wj i lj k r
the	i lj
ties	s
tours	h o k r k s
tunisia	k s
turkey	o i kj i lj
ukraine	u k r i lj
ukrainian	u k r
ukrainians	u k r k s
united	i lj
uzbekistan	r b n e i kj k s
viceland	i lj
was	k s
wiedertaeufer	wj n e i lj o i lj n e o
will	wj
with	wj
world	h o k r
your	h o k r
zaccarie	k r i lj
zealand	i lj
а	a
аби	a b y
або	a b o
абуда	a b u d a
австралійська	a w s t r a lj i j sj k a
австралійський	a w s t r a lj i j sj k y j
австралійських	a w s t r a lj i j sj k y x
австралійського	a w s t r a lj i j sj k o h o
австралійською	a w s t r a lj i j sj k o j u
австралійської	a w s t r a lj i j sj k o j i
австралійську	a w s t r a lj i j sj k u
австралійські	a w s t r a lj i j sj kj i
австралійці	a w s t r a lj i j tsj i
австралійців	a w s t r a lj i j tsj i w
австралію	a w s t r a lj i j u
австралія	a w s t r a lj i j a
австралії	a w s t r a lj i j i
авів	a wj i w
авіві	a wj i wj i
агентством	a h e n ts t w o m
агресивних	a h r e s y w n y x
агресора	a h r e s o r a
агресію	a h r e sj i j u
агресії	a h r e sj i j i
адвокати	a d w o k a t y
аделаїда	a d e l a j i d a
адміністрації	a d mj i nj i s t r a tsj i j i
азовському	a z o w sj k o m u
академію	a k a d e mj i j u
акти	a k t y
активно	a k t y w n o
активізувалася	a k t y wj i z u w a l a sj a
активісти	a k t y wj i s t y
актор	a k t o r
акту	a k t u
акціонерного	a k tsj i o n e r n o h o
але	a l e
аль	a lj
алідоро	a lj i d o r o
америки	a m e r y k y
амес	a m e s
аналіз	a n a lj i z
андрієм	a n d rj i j e m
анексії	a n e k sj i j i
антирасистські	a n t y r a s y s sj kj i
ану	a n u
аргументів	a r h u m e nj tj i w
асоціації	a s o tsj i a tsj i j i
аґресії	a r e sj i j i
бабусь	b a b u sj
багато	b a h a t o
багатокультурного	b a h a t o k u lj t u r n o h o
багатьох	b a h a tj o x
бажають	b a zh a j u tj
бангкока	b a n x k o k a
банківську	b a n kj i w sj k u
басейн	b a s e j n
басейновій	b a s e j n o wj i j
батьками	b a tj k a m y
батько	b a tj k o
батьків	b a tj kj i w
безпека	b e z p e k a
безпеки	b e z p e k y
безпритульность	b e z p r y t u lj n o sj tj
бере	b e r e
береджікліян	b e r e dzh i k lj i j a n
бережанський	b e r e zh a nj sj k y j
берлінської	b e r lj i nj sj k o j i
би	b y
благополуччя	b l a h o p o l u tsh tshj a
близько	b l y zj k o
блоку	b l o k u
богдан	b o h d a n
боров	b o r o w
боротьби	b o r o dj b y
брали	b r a l y
брат	b r a t
був	b u w
буде	b u d e
будемо	b u d e m o
будете	b u d e t e
будинків	b u d y n kj i w
будинок	b u d y n o k
будувати	b u d u w a t y
була	b u l a
були	b u l y
було	b u l o
бурхливий	b u r x l y w y j
бурхливо	b u r x l y w o
бути	b u t y
буття	b u tj tj a
бюджет	bj u dzh e t
бюджетах	bj u dzh e t a x
бюджеті	bj u dzh e tj i
біженським	bj i zh e nj sj k y m
біженців	bj i zh e nj tsj i w
більш	bj i lj sh
більше	bj i lj sh e
більшості	bj i lj sh o sj tj i
більшу	bj i lj sh u
бішоп	bj i sh o p
в	w
важливий	w a zh l y w y j
важливі	w a zh l y wj i
вакцинації	w a k ts y n a tsj i j i
валії	w a lj i j i
вануату	w a n u a t u
варіанти	w a rj i a n t y
вас	w a s
василем	w a s y l e m
вбивають	w b y w a j u tj
вважають	w w a zh a j u tj
вважає	w w a zh a j e
вважається	w w a zh a j e tsj tsj a
ввечері	w w e tsh e rj i
веганську	w e h a nj sj k u
веде	w e d e
ведуть	w e d u tj
велику	w e l y k u
вже	w zh e
взяти	w zj a t y
ви	w y
виборами	w y b o r a m y
виборах	w y b o r a x
вибори	w y b o r y
виборці	w y b o r tsj i
виборців	w y b o r tsj i w
виборчою	w y b o r tsh o j u
виборчої	w y b o r tsh o j i
виборів	w y b o rj i w
виверженням	w y w e r zh e nj nj a m
виголосили	w y h o l o s y l y
виголосить	w y h o l o s y tj
визначилися	w y z n a tsh y l y sj a
визначиться	w y z n a tsh y tsj tsj a
визнають	w y z n a j u tj
визнає	w y z n a j e
викликали	w y k l y k a l y
виконуючою	w y k o n u j u tsh o j u
використання	w y k o r y s t a nj nj a
використовують	w y k o r y s t o w u j u tj
вина	w y n a
виникли	w y n y k l y
виноградники	w y n o h r a d n y k y
виноробні	w y n o r o b nj i
випливає	w y p l y w a j e
випробування	w y p r o b u w a nj nj a
вироку	w y r o k u
висловила	w y s l o w y l a
висловили	w y s l o w y l y
високодостойна	w y s o k o d o s t o j n a
високодостойним	w y s o k o d o s t o j n y m
високопоставлений	w y s o k o p o s t a w l e n y j
виставку	w y s t a w k u
виступу	w y s t u p u
витрат	w y t r a t
витрати	w y t r a t y
витягнути	w y tj a h n u t y
вихідні	w y xj i dj nj i
вишукані	w y sh u k a nj i
виявила	w y j a w y l a
виявили	w y j a w y l y
виявило	w y j a w y l o
виїхала	w y j i x a l a
вказують	w k a z u j u tj
включають	w k lj u tsh a j u tj
вкрасти	w k r a s t y
власників	w l a s n y kj i w
власного	w l a s n o h o
власністю	w l a sj nj i sj tj u
внаслідок	w n a sj lj i d o k
вогнів	w o h nj i w
водах	w o d a x
волині	w o l y nj i
володимир	w o l o d y m y r
вона	w o n a
вони	w o n y
воєнного	w o j e n n o h o
все	w s e
всенаціонального	w s e n a tsj i o n a lj n o h o
всесвітнього	w s e sj wj i tj nj o h o
всьому	w sj o m u
втекла	w t e k l a
вулкану	w u l k a n u
вчені	w tsh e nj i
вчинила	w tsh y n y l a
вчителів	w tsh y t e lj i w
вшанування	w sh a n u w a nj nj a
від	wj i d
відбору	wj i d b o r u
відбувся	wj i d b u w sj a
відбудуться	wj i d b u d u tsj tsj a
відбутися	wj i d b u t y sj a
відволікти	wj i d w o lj i k t y
відвідала	wj i d wj i d a l a
відвідини	wj i d wj i d y n y
віддати	wj i d d a t y
відзначали	wj i dz z n a tsh a l y
відзначається	wj i dz z n a tsh a j e tsj tsj a
відкинувши	wj i d k y n u w sh y
відкликання	wj i d k l y k a nj nj a
відкрила	wj i d k r y l a
відмовилася	wj i d m o w y l a sj a
відмовилися	wj i d m o w y l y sj a
відносин	wj i d n o s y n
відомою	wj i d o m o j u
відповідає	wj i d p o wj i d a j e
відповідь	wj i d p o wj i dj
відповіді	wj i d p o wj i dj i
відсотка	wj i dz s o t k a
відсотків	wj i dz s o t kj i w
відставку	wj i dz s t a w k u
відсіч	wj i dz s i tsh
відчувають	wj i tsh tsh u w a j u tj
відібрані	wj i dj i b r a nj i
візи	wj i z y
війна	wj i j n a
війни	wj i j n y
війні	wj i j nj i
віком	wj i k o m
вікторіянської	wj i k t o rj i j a nj sj k o j i
вікторії	wj i k t o rj i j i
вільнюський	wj i lj nj u sj k y j
він	wj i n
віни	wj i n y
вістки	wj i s t k y
вітаємо	wj i t a j e m o
віце	wj i ts e
віці	wj i tsj i
генерального	h e n e r a lj n o h o
генетичну	h e n e t y tsh n u
генів	h e nj i w
глави	h l a w y
главу	h l a w u
го	h o
говоримо	h o w o r y m o
говорять	h o w o rj a tj
головних	h o l o w n y x
головою	h o l o w o j u
голодом	h o l o d o m
голодомор	h o l o d o m o r
голос	h o l o s
голосування	h o l o s u w a nj nj a
голосувати	h o l o s u w a t y
голосуватимуть	h o l o s u w a t y m u tj
голосуючих	h o l o s u j u tsh y x
голосів	h o l o sj i w
гостя	h o sj tj a
греко	h r e k o
гремін	h r e mj i n
громад	h r o m a d
громади	h r o m a d y
громадян	h r o m a dj a n
громадянства	h r o m a dj a n s t w a
гроші	h r o shj i
грудня	h r u dj nj a
грудні	h r u dj nj i
групи	h r u p y
грібаускайте	h rj i b a u s k a j t e
гуманітарних	h u m a nj i t a r n y x
гуманітарної	h u m a nj i t a r n o j i
гідності	hj i d n o sj tj i
гіперзвукової	hj i p e r z w u k o w o j i
д	d
давидовська	d a w y d o w sj k a
даля	d a lj a
далі	d a lj i
дана	d a n a
дарлінг	d a r lj i n h
дату	d a t u
двобої	d w o b o j i
двох	d w o x
дебатах	d e b a t a x
дебати	d e b a t y
делеґацією	d e l e a tsj i j e j u
делеґації	d e l e a tsj i j i
день	d e nj
депутат	d e p u t a t
держави	d e r zh a w y
державний	d e r zh a w n y j
державу	d e r zh a w u
десятиліття	d e sj a t y lj i tj tj a
десять	d e sj a tj
дещо	d e sh tsh o
деякі	d e j a kj i
джанні	dzh a nj nj i
джерела	dzh e r e l a
джош	dzh o sh
джоша	dzh o sh a
джулі	dzh u lj i
дика	d y k a
дипломатичних	d y p l o m a t y tsh n y x
дискримінації	d y s k r y mj i n a tsj i j i
дитина	d y t y n a
дитячому	d y tj a tsh o m u
для	dj lj a
дня	dj nj a
днями	dj nj a m y
днів	dj nj i w
до	d o
довгим	d o w h y m
довговічні	d o w h o wj i tsh nj i
доведено	d o w e d e n o
довкілля	d o w kj i lj lj a
доглядає	d o h lj a d a j e
додаткові	d o d a t k o wj i
дозволить	d o z w o l y tj
докладають	d o k l a d a j u tj
доктором	d o k t o r o m
документом	d o k u m e n t o m
долар	d o l a r
долара	d o l a r a
домінують	d o mj i n u j u tj
донбасі	d o n b a sj i
донори	d o n o r y
донорів	d o n o rj i w
допомагали	d o p o m a h a l y
допомагають	d o p o m a h a j u tj
допомоги	d o p o m o h y
допомогли	d o p o m o h l y
допомогу	d o p o m o h u
дорошем	d o r o sh e m
досвід	d o sj wj i d
дослідження	d o sj lj i dzh e nj nj a
дослідженні	d o sj lj i dzh e nj nj i
дослідники	d o sj lj i d n y k y
досягти	d o sj a x t y
досяжною	d o sj a zh n o j u
доходи	d o x o d y
доходом	d o x o d o m
др	d r
другий	d r u h y j
думку	d u m k u
дідусів	dj i d u sj i w
дізнавайтеся	dj i z n a w a j t e sj a
ділить	dj i l y tj
дільницях	dj i lj n y tsj a x
дітей	dj i t e j
діяльності	dj i j a lj n o sj tj i
дієту	dj i j e t u
дії	dj i j i
е	e
екологічною	e k o l o hj i tsh n o j u
економіку	e k o n o mj i k u
економічних	e k o n o mj i tsh n y x
економічного	e k o n o mj i tsh n o h o
екс	e k s
ексклюзивне	e k s k lj u z y w n e
експерти	e k s p e r t y
експорт	e k s p o r t
еліною	e lj i n o j u
енергію	e n e r hj i j u
енергії	e n e r hj i j i
ентузіазм	e n t u zj i a z m
ескалації	e s k a l a tsj i j i
етап	e t a p
ж	zh
же	zh e
жертв	zh e r t w
жертвами	zh e r t w a m y
живий	zh y w y j
життя	zh y tj tj a
життів	zh y tj tj i w
жорстких	zh o r s t k y x
жінки	zhj i n k y
жінок	zhj i n o k
з	z
за	z a
заарештували	z a a r e sh t u w a l y
забезпечити	z a b e z p e tsh y t y
забрали	z a b r a l y
завдання	z a w d a nj nj a
завершив	z a w e r sh y w
загальне	z a h a lj n e
загальної	z a h a lj n o j i
загальні	z a h a lj nj i
загарбницька	z a h a r b n y tsj k a
зайняла	z a j nj a l a
закликами	z a k l y k a m y
закликаю	z a k l y k a j u
закликають	z a k l y k a j u tj
закликає	z a k l y k a j e
заклики	z a k l y k y
закони	z a k o n y
законом	z a k o n o m
законопроект	z a k o n o p r o e k t
закордонних	z a k o r d o n n y x
закінчена	z a kj i n tsh e n a
закінчив	z a kj i n tsh y w
закінчився	z a kj i n tsh y w sj a
залишається	z a l y sh a j e tsj tsj a
залишили	z a l y sh y l y
залишилося	z a l y sh y l o sj a
замість	z a mj i sj tj
занепокоєння	z a n e p o k o j e nj nj a
заохочують	z a o x o tsh u j u tj
заощадять	z a o sh tsh a dj a tj
запалила	z a p a l y l a
записів	z a p y sj i w
запитували	z a p y t u w a l y
започаткувала	z a p o tsh a t k u w a l a
запровадження	z a p r o w a dzh e nj nj a
запропонований	z a p r o p o n o w a n y j
запрошення	z a p r o sh e nj nj a
зараз	z a r a z
зареєстровано	z a r e j e s t r o w a n o
зареєстровані	z a r e j e s t r o w a nj i
зареєструватися	z a r e j e s t r u w a t y sj a
заробляють	z a r o b lj a j u tj
заслуги	z a s l u h y
заснувала	z a s n u w a l a
засоби	z a s o b y
заставили	z a s t a w y l y
засуджених	z a s u dzh e n y x
засідання	z a sj i d a nj nj a
засіданні	z a sj i d a nj nj i
затверджені	z a t w e r dzh e nj i
затримали	z a t r y m a l y
захисту	z a x y s t u
захистять	z a x y sj tj a tj
захисті	z a x y sj tj i
заходи	z a x o d y
захопила	z a x o p y l a
захоплення	z a x o p l e nj nj a
західної	z a xj i d n o j i
зацікавленість	z a tsj i k a w l e nj i sj tj
заявила	z a j a w y l a
збережено	z b e r e zh e n o
зворотній	z w o r o tj nj i j
звіту	zj wj i t u
згаданої	z h a d a n o j i
згідно	z hj i d n o
здобув	z d o b u w
здоров	z d o r o w
зеленський	z e l e nj sj k y j
зеленським	z e l e nj sj k y m
земель	z e m e lj
землях	z e m lj a x
злочини	z l o tsh y n y
зменшується	z m e n sh u j e tsj tsj a
зміна	zj mj i n a
змінити	zj mj i n y t y
зміною	zj mj i n o j u
змінюватися	zj mj i nj u w a t y sj a
зміцненні	zj mj i ts n e nj nj i
зміцнювати	zj mj i ts nj u w a t y
змішану	zj mj i sh a n u
знадобитися	z n a d o b y t y sj a
знайти	z n a j t y
значення	z n a tsh e nj nj a
значну	z n a tsh n u
зневаживши	z n e w a zh y w sh y
зниження	z n y zh e nj nj a
знизився	z n y z y w sj a
знизити	z n y z y t y
знизяться	z n y zj a tsj tsj a
зняла	zj nj a l a
зобов	z o b o w
зокрема	z o k r e m a
зондській	z o nj dzj sj kj i j
зробити	z r o b y t y
зростання	z r o s t a nj nj a
зростанням	z r o s t a nj nj a m
зростає	z r o s t a j e
зруйнували	z r u j n u w a l y
зсуви	z s u w y
зуніга	z u nj i h a
зустрівся	z u s t rj i w sj a
зустріла	z u s t rj i l a
зустрічі	z u s t rj i tshj i
зі	zj i
й	j
йдеться	j d e tsj tsj a
ймовірно	j m o wj i r n o
його	j o h o
кажуть	k a zh u tj
кампанії	k a m p a nj i j i
канберрі	k a n b e r rj i
канберу	k a n b e r u
кандидатами	k a n d y d a t a m y
кандидати	k a n d y d a t y
кандидатів	k a n d y d a tj i w
кармен	k a r m e n
катастрофою	k a t a s t r o f o j u
католицького	k a t o l y tsj k o h o
католицької	k a t o l y tsj k o j i
квадратних	k w a d r a t n y x
квот	k w o t
квоти	k w o t y
квітня	k wj i tj nj a
керченській	k e r tsh e nj sj kj i j
керівництва	k e rj i w n y ts t w a
китай	k y t a j
китайських	k y t a j sj k y x
китаю	k y t a j u
києва	k y j e w a
київ	k y j i w
клайпеда	k l a j p e d a
клекотати	k l e k o t a t y
клімату	k lj i m a t u
клітин	k lj i t y n
коала	k o a l a
коаліційний	k o a lj i tsj i j n y j
коаліція	k o a lj i tsj i j a
кого	k o h o
кожним	k o zh n y m
коли	k o l y
колоніальному	k o l o nj i a lj n o m u
комплексу	k o m p l e k s u
комісія	k o mj i sj i j a
комісією	k o mj i sj i j e j u
комісії	k o mj i sj i j i
комітету	k o mj i t e t u
конвенцій	k o n w e nj tsj i j
конкурс	k o n k u r s
конкурсу	k o n k u r s u
конкурсі	k o n k u r sj i
конституційно	k o n s t y t u tsj i j n o
конституційні	k o n s t y t u tsj i j nj i
контрактом	k o n t r a k t o m
конфлікту	k o n f lj i k t u
конґресу	k o n r e s u
кораблі	k o r a b lj i
корейських	k o r e j sj k y x
король	k o r o lj
королівська	k o r o lj i w sj k a
королівській	k o r o lj i w sj kj i j
кору	k o r u
космосу	k o s m o s u
котра	k o t r a
котрі	k o t rj i
краще	k r a sh tsh e
країн	k r a j i n
країнах	k r a j i n a x
країни	k r a j i n y
країною	k r a j i n o j u
криму	k r y m u
критикує	k r y t y k u j e
крові	k r o wj i
культурно	k u lj t u r n o
кулінич	k u lj i n y tsh
кулінічем	k u lj i nj i tsh e m
кунун	k u n u n
купувати	k u p u w a t y
кілда	kj i l d a
кілометрів	kj i l o m e t rj i w
кілька	kj i lj k a
кількості	kj i lj k o sj tj i
кількох	kj i lj k o x
кількість	kj i lj kj i sj tj
кількістю	kj i lj kj i sj tj u
кінофільм	kj i n o fj i lj m
кінці	kj i nj tsj i
ла	l a
лейбористи	l e j b o r y s t y
лейбористська	l e j b o r y sj tsj k a
липні	l y p nj i
листопада	l y s t o p a d a
литви	l y t w y
литовських	l y t o w sj k y x
литовської	l y t o w sj k o j i
лише	l y sh e
людей	lj u d e j
людини	lj u d y n y
людям	lj u dj a m
лютого	lj u t o h o
ліберальний	lj i b e r a lj n y j
лідери	lj i d e r y
лідерів	lj i d e rj i w
лікарень	lj i k a r e nj
лікарні	lj i k a r nj i
лікарі	lj i k a rj i
лікування	lj i k u w a nj nj a
лінгвістичного	lj i n h wj i s t y tsh n o h o
літо	lj i t o
ліття	lj i tj tj a
майбутні	m a j b u tj nj i
майже	m a j zh e
мала	m a l a
малим	m a l y m
мандрівки	m a n d rj i w k y
мар	m a r
мають	m a j u tj
маютьвідбутися	m a j u tj wj i d b u t y sj a
має	m a j e
маємо	m a j e m o
медичної	m e d y tsh n o j i
мельбурні	m e lj b u r nj i
менеджерів	m e n e dzh e rj i w
менше	m e n sh e
мета	m e t a
мети	m e t y
методи	m e t o d y
мету	m e t u
ми	m y
микола	m y k o l a
миколою	m y k o l o j u
минулого	m y n u l o h o
минулому	m y n u l o m u
минулої	m y n u l o j i
мирного	m y r n o h o
млн	m l n
мова	m o w a
мовити	m o w y t y
мовний	m o w n y j
мовних	m o w n y x
мовного	m o w n o h o
модель	m o d e lj
модернізації	m o d e r nj i z a tsj i j i
модифікацію	m o d y fj i k a tsj i j u
може	m o zh e
можлива	m o zh l y w a
можливостями	m o zh l y w o sj tj a m y
можна	m o zh n a
можуть	m o zh u tj
молодіжної	m o l o dj i zh n o j i
момент	m o m e n t
моменти	m o m e n t y
моррісон	m o r rj i s o n
моря	m o rj a
морі	m o rj i
мохаммед	m o x a m m e d
музичний	m u z y tsh n y j
музичну	m u z y tsh n u
мюллер	mj u l l e r
мюррей	mj u r r e j
міг	mj i h
мігрантським	mj i h r a nj tsj k y m
міграційною	mj i h r a tsj i j n o j u
міждержавних	mj i zh d e r zh a w n y x
міжнародних	mj i zh n a r o d n y x
міжнародного	mj i zh n a r o d n o h o
міжнародному	mj i zh n a r o d n o m u
міжнародної	mj i zh n a r o d n o j i
міжнародні	mj i zh n a r o dj nj i
мільйона	mj i lj j o n a
мільйонів	mj i lj j o nj i w
мінських	mj i nj sj k y x
міністер	mj i nj i s t e r
міністр	mj i nj i s t r
міністрoм	mj i nj i s t r h o m
міністра	mj i nj i s t r a
міністрами	mj i nj i s t r a m y
міністром	mj i nj i s t r o m
місце	mj i s ts e
місцеві	mj i s ts e wj i
місцями	mj i sj tsj a m y
місяця	mj i sj a tsj a
місяці	mj i sj a tsj i
місяців	mj i sj a tsj i w
міґрантів	mj i r a nj tj i w
міґрацію	mj i r a tsj i j u
на	n a
набравши	n a b r a w sh y
набрати	n a b r a t y
навантажених	n a w a n t a zh e n y x
навколишнього	n a w k o l y sh nj o h o
навчання	n a w tsh a nj nj a
нагоди	n a h o d y
наголошують	n a h o l o sh u j u tj
нагороджено	n a h o r o dzh e n o
надання	n a d a nj nj a
надати	n a d a t y
надзвичайний	n a dz z w y tsh a j n y j
надзвичайним	n a dz z w y tsh a j n y m
надзвичайні	n a dz z w y tsh a j nj i
надлишку	n a d l y sh k u
надії	n a dj i j i
назад	n a z a d
найбільш	n a j bj i lj sh
найбільшою	n a j bj i lj sh o j u
найбільші	n a j bj i lj shj i
найважливіші	n a j w a zh l y wj i shj i
найнижчого	n a j n y zh tsh o h o
найстрашнішої	n a j s t r a sh nj i sh o j i
найцікавіш	n a j tsj i k a wj i sh
найцікавіші	n a j tsj i k a wj i shj i
найчастіше	n a j tsh a sj tj i sh e
наливайко	n a l y w a j k o
намір	n a mj i r
намірам	n a mj i r a m
намічав	n a mj i tsh a w
напередодні	n a p e r e d o dj nj i
нарешті	n a r e sh tj i
народженню	n a r o dzh e nj nj u
нас	n a s
населення	n a s e l e nj nj a
настав	n a s t a w
наступних	n a s t u p n y x
наступного	n a s t u p n o h o
наступні	n a s t u p nj i
наталією	n a t a lj i j e j u
науково	n a u k o w o
наукового	n a u k o w o h o
національна	n a tsj i o n a lj n a
національний	n a tsj i o n a lj n y j
національного	n a tsj i o n a lj n o h o
національну	n a tsj i o n a lj n u
національній	n a tsj i o n a lj nj i j
нація	n a tsj i j a
наше	n a sh e
наших	n a sh y x
не	n e
небагатьох	n e b a h a tj o x
невід	n e wj i d
недавні	n e d a w nj i
недбалість	n e d b a lj i sj tj
неділі	n e dj i lj i
незаконної	n e z a k o n n o j i
незаконні	n e z a k o nj nj i
незалежно	n e z a l e zh n o
незважаючи	n e z w a zh a j u tsh y
нейтральних	n e j t r a lj n y x
необхідності	n e o b xj i d n o sj tj i
нерухомості	n e r u x o m o sj tj i
нерухомість	n e r u x o mj i sj tj
нестійким	n e sj tj i j k y m
нещодавно	n e sh tsh o d a w n o
нещодавнього	n e sh tsh o d a w nj o h o
нижчого	n y zh tsh o h o
них	n y x
новий	n o w y j
новим	n o w y m
новини	n o w y n y
нових	n o w y x
новоприбулих	n o w o p r y b u l y x
нової	n o w o j i
нові	n o wj i
новітні	n o wj i tj nj i
номера	n o m e r a
нсту	n s t u
нього	nj o h o
ніж	nj i zh
ніколенко	nj i k o l e n k o
об	o b
обдумував	o b d u m u w a w
обережними	o b e r e zh n y m y
обидва	o b y d w a
обирати	o b y r a t y
обирає	o b y r a j e
обйідеться	o b j i d e tsj tsj a
обмеженими	o b m e zh e n y m y
обов	o b o w
обраних	o b r a n y x
обставинах	o b s t a w y n a x
обіцянки	o bj i tsj a n k y
обіцяє	o bj i tsj a j e
оголосив	o h o l o s y w
оголосити	o h o l o s y t y
оголошених	o h o l o sh e n y x
оголошено	o h o l o sh e n o
оголошеному	o h o l o sh e n o m u
одержимість	o d e r zh y mj i sj tj
одеська	o d e sj k a
одна	o d n a
одним	o d n y m
одного	o d n o h o
однією	o dj nj i j e j u
однієї	o dj nj i j e j i
ознаменувався	o z n a m e n u w a w sj a
означає	o z n a tsh a j e
окрім	o k rj i m
окупації	o k u p a tsj i j i
олег	o l e h
олімпійського	o lj i m pj i j sj k o h o
онлайн	o n l a j n
оновлення	o n o w l e nj nj a
онєгіні	o nj e hj i nj i
оон	o o n
опері	o p e rj i
опитування	o p y t u w a nj nj a
оплатою	o p l a t o j u
опозиція	o p o z y tsj i j a
опонент	o p o n e n t
оприлюднив	o p r y lj u d n y w
опублікований	o p u b lj i k o w a n y j
опікою	o pj i k o j u
опісля	o pj i sj lj a
органів	o r h a nj i w
організацій	o r h a nj i z a tsj i j
організація	o r h a nj i z a tsj i j a
освіту	o sj wj i t u
оскільки	o s kj i lj k y
основних	o s n o w n y x
основні	o s n o w nj i
особисті	o s o b y sj tj i
особливо	o s o b l y w o
останнє	o s t a nj nj e
останні	o s t a nj nj i
останніх	o s t a nj nj i x
остаточне	o s t a t o tsh n e
остаточного	o s t a t o tsh n o h o
ось	o sj
осіб	o sj i b
отже	o dzh zh e
отримали	o t r y m a l y
офіційних	o fj i tsj i j n y x
офіційно	o fj i tsj i j n o
офіційні	o fj i tsj i j nj i
охоплює	o x o p lj u j e
охорони	o x o r o n y
очах	o tsh a x
очолив	o tsh o l y w
очолила	o tsh o l y l a
очікування	o tshj i k u w a nj nj a
очікується	o tshj i k u j e tsj tsj a
п	p
палату	p a l a t u
пам	p a m
пан	p a n
пана	p a n a
панами	p a n a m y
паном	p a n o m
пані	p a nj i
парламентом	p a r l a m e n t o m
парламенту	p a r l a m e n t u
партій	p a r tj i j
партія	p a r tj i j a
пацієнта	p a tsj i j e n t a
пацієнтам	p a tsj i j e n t a m
пбувала	p b u w a l a
педагогічний	p e d a h o hj i tsh n y j
перебуває	p e r e b u w a j e
переваги	p e r e w a h y
переважною	p e r e w a zh n o j u
переговорів	p e r e h o w o rj i w
перед	p e r e d
передбачає	p e r e d b a tsh a j e
передвиборчому	p e r e d w y b o r tsh o m u
передвиборчі	p e r e d w y b o r tshj i
переконати	p e r e k o n a t y
переможцями	p e r e m o zj tsj a m y
переможці	p e r e m o zj tsj i
переміг	p e r e mj i h
перетворити	p e r e t w o r y t y
переїхала	p e r e j i x a l a
перипетії	p e r y p e tj i j i
перший	p e r sh y j
першим	p e r sh y m
першому	p e r sh o m u
першочерговим	p e r sh o tsh e r h o w y m
першою	p e r sh o j u
період	p e rj i o d
періодів	p e rj i o dj i w
петра	p e t r a
петро	p e t r o
питанням	p y t a nj nj a m
питань	p y t a nj
план	p l a n
плани	p l a n y
плану	p l a n u
планується	p l a n u j e tsj tsj a
площу	p l o sh tsh u
пляжі	p lj a zhj i
по	p o
побачення	p o b a tsh e nj nj a
побачити	p o b a tsh y t y
побив	p o b y w
побоювання	p o b o j u w a nj nj a
повернення	p o w e r n e nj nj a
повернути	p o w e r n u t y
повинні	p o w y nj nj i
повноваження	p o w n o w a zh e nj nj a
повноважний	p o w n o w a zh n y j
повноважним	p o w n o w a zh n y m
повномасштабна	p o w n o m a s sh t a b n a
повної	p o w n o j i
повідомив	p o wj i d o m y w
повідомила	p o wj i d o m y l a
повідомляючи	p o wj i d o m lj a j u tsh y
погашення	p o h a sh e nj nj a
податкова	p o d a t k o w a
податкове	p o d a t k o w e
податковий	p o d a t k o w y j
податкову	p o d a t k o w u
податку	p o d a t k u
подвоєння	p o d w o j e nj nj a
подвоїти	p o d w o j i t y
подорожній	p o d o r o zh nj i j
подібних	p o dj i b n y x
події	p o dj i j i
пожежників	p o zh e zh n y kj i w
пожежі	p o zh e zhj i
показав	p o k a z a w
показало	p o k a z a l o
показують	p o k a z u j u tj
поки	p o k y
покращує	p o k r a sh tsh u j e
полишає	p o l y sh a j e
положення	p o l o zh e nj nj a
польщею	p o lj sh tsh e j u
полягає	p o lj a h a j e
поліпшення	p o lj i p sh e nj nj a
політиканство	p o lj i t y k a n s t w o
політикою	p o lj i t y k o j u
політиці	p o lj i t y tsj i
поліція	p o lj i tsj i j a
поміж	p o mj i zh
помічниця	p o mj i tsh n y tsj a
понад	p o n a d
поновлювані	p o n o w lj u w a nj i
поновлюють	p o n o w lj u j u tj
попередньо	p o p e r e dj nj o
попередніх	p o p e r e dj nj i x
порозі	p o r o zj i
порошенка	p o r o sh e n k a
порошенко	p o r o sh e n k o
порошенком	p o r o sh e n k o m
портфоліо	p o r t f o lj i o
порушення	p o r u sh e nj nj a
порушила	p o r u sh y l a
порівнянні	p o rj i w nj a nj nj i
поріг	p o rj i h
посадах	p o s a d a x
посадка	p o s a d k a
послом	p o s l o m
посол	p o s o l
посольство	p o s o lj s t w o
постраждали	p o s t r a zh d a l y
постійного	p o sj tj i j n o h o
постійної	p o sj tj i j n o j i
посів	p o sj i w
потерпіли	p o t e r pj i l y
потерпілих	p o t e r pj i l y x
поточного	p o t o tsh n o h o
поточній	p o t o tsh nj i j
потреби	p o t r e b y
потребують	p o t r e b u j u tj
потім	p o tj i m
почав	p o tsh a w
початок	p o tsh a t o k
почуттям	p o tsh u tj tj a m
поштою	p o sh t o j u
пошуку	p o sh u k u
поїхал	p o j i x a l
поїхати	p o j i x a t y
прав	p r a w
правила	p r a w y l a
право	p r a w o
правові	p r a w o wj i
православна	p r a w o s l a w n a
прагне	p r a h n e
працює	p r a tsj u j e
працівників	p r a tsj i w n y kj i w
представив	p r e dz s t a w y w
представляли	p r e dz s t a w lj a l y
представника	p r e dz s t a w n y k a
представники	p r e dz s t a w n y k y
представників	p r e dz s t a w n y kj i w
представництва	p r e dz s t a w n y ts t w a
президент	p r e z y d e n t
президента	p r e z y d e n t a
президенти	p r e z y d e n t y
президентом	p r e z y d e n t o m
президентських	p r e z y d e nj tsj k y x
президентські	p r e z y d e nj tsj k i
прем	p r e m
прес	p r e s
при	p r y
приблизно	p r y b l y z n o
прибудуть	p r y b u d u tj
прибула	p r y b u l a
прибули	p r y b u l y
прибуток	p r y b u t o k
приводом	p r y w o d o m
привітання	p r y wj i t a nj nj a
придумати	p r y d u m a t y
призвести	p r y z w e s t y
приземлилася	p r y z e m l y l a sj a
призначена	p r y z n a tsh e n a
прийняття	p r y j nj a tj tj a
прийняті	p r y j nj a tj i
прийшов	p r y j sh o w
приналежність	p r y n a l e zh nj i sj tj
приносять	p r y n o sj a tj
природа	p r y r o d a
присвячене	p r y sj wj a tsh e n e
присвяченого	p r y sj wj a tsh e n o h o
притулку	p r y t u l k u
приховуючи	p r y x o w u j u tsh y
приходять	p r y x o dj a tj
приятелі	p r y j a t e lj i
приєднатися	p r y j e d n a t y sj a
приїздом	p r y j i z d o m
про	p r o
проблемами	p r o b l e m a m y
проведення	p r o w e d e nj nj a
проводить	p r o w o d y tj
провідних	p r o wj i d n y x
прогнозування	p r o h n o z u w a nj nj a
проголосували	p r o h o l o s u w a l y
проголосують	p r o h o l o s u j u tj
програм	p r o h r a m
програма	p r o h r a m a
програми	p r o h r a m y
проекти	p r o e k t y
проектів	p r o e k tj i w
проживають	p r o zh y w a j u tj
пройде	p r o j d e
пройти	p r o j t y
пропозиції	p r o p o z y tsj i j i
проте	p r o t e
протестів	p r o t e sj tj i w
проти	p r o t y
протоці	p r o t o tsj i
протягом	p r o tj a h o m
прохання	p r o x a nj nj a
прірви	p rj i r w y
пуерто	p u e r t o
південної	pj i w d e n n o j i
під	pj i d
підводні	pj i d w o dj nj i
підписання	pj i d p y s a nj nj a
підприємництво	pj i d p r y j e m n y ts t w o
підприємницької	pj i d p r y j e m n y tsj k o j i
підприємства	pj i d p r y j e m s t w a
підряд	pj i d rj a d
підсумки	pj i dz s u m k y
підтримки	pj i d t r y m k y
підтримують	pj i d t r y m u j u tj
підтримує	pj i d t r y m u j e
підуть	pj i d u tj
пісенний	pj i s e n n y j
пісенному	pj i s e n n o m u
після	pj i sj lj a
пішла	pj i sh l a
р	r
рада	r a d a
радбезу	r a d b e z u
радянського	r a dj a nj sj k o h o
радіо	r a dj i o
раз	r a z
рак	r a k
ракетної	r a k e t n o j i
раку	r a k u
раситські	r a s y t sj kj i
рахаф	r a x a f
рахунок	r a x u n o k
реакцію	r e a k tsj i j u
реальність	r e a lj nj i sj tj
революція	r e w o lj u tsj i j a
редагування	r e d a h u w a nj nj a
резолюцію	r e z o lj u tsj i j u
резолюції	r e z o lj u tsj i j i
рекордне	r e k o r d n e
релігійних	r e lj i hj i j n y x
рене	r e n e
республіки	r e s p u b lj i k y
реформа	r e f o r m a
речей	r e tsh e j
речник	r e tsh n y k
речників	r e tsh n y kj i w
рико	r y k o
ринку	r y n k u
роботи	r o b o t y
роз	r o z
розвивається	r o z w y w a j e tsj tsj a
розвідки	r o zj wj i d k y
розгляду	r o z h lj a d u
розмови	r o z m o w y
розмовляє	r o z m o w lj a j e
розмову	r o z m o w u
розпочала	r o z p o tsh a l a
розпочалася	r o z p o tsh a l a sj a
розробити	r o z r o b y t y
розслідування	r o z sj lj i d u w a nj nj a
розхвалюють	r o z x w a lj u j u tj
роками	r o k a m y
роки	r o k y
роковин	r o k o w y n
роком	r o k o m
року	r o k u
років	r o kj i w
романівим	r o m a nj i w y m
російською	r o sj i j sj k o j u
росію	r o sj i j u
росія	r o sj i j a
росією	r o sj i j e j u
росії	r o sj i j i
році	r o tsj i
рудницький	r u d n y tsj k y j
руйнівні	r u j nj i w nj i
ряд	rj a d
рятувати	rj a t u w a t y
рівня	rj i w nj a
рівням	rj i w nj a m
рівність	rj i w nj i sj tj
ріголетто	rj i h o l e t t o
рідних	rj i d n y x
різдвяні	rj i z d w a nj i
різке	rj i z k e
різноманіття	rj i z n o m a nj i tj tj a
рік	rj i k
ріці	rj i tsj i
річковою	rj i tsh k o w o j u
річна	rj i tsh n a
річницю	rj i tsh n y tsj u
річниці	rj i tsh n y tsj i
рішення	rj i sh e nj nj a
самого	s a m o h o
самозайнятості	s a m o z a j nj a t o sj tj i
самітніми	s a mj i tj nj i m y
санкцій	s a n k tsj i j
саудівської	s a u dj i w sj k o j i
свині	s w y nj i
свитоліною	s w y t o lj i n o j u
свого	s w o h o
свою	s w o j u
своєї	s w o j e j i
свої	s w o j i
свято	sj wj a t o
свій	sj wj i j
світ	sj wj i t
світове	sj wj i t o w e
світового	sj wj i t o w o h o
світові	sj wj i t o wj i
світу	sj wj i t u
світі	sj wj i tj i
сезоні	s e z o nj i
секретаря	s e k r e t a rj a
сенат	s e n a t
сенерентола	s e n e r e n t o l a
сент	s e n t
середини	s e r e d y n y
середовища	s e r e d o w y sh tsh a
серйозні	s e r j o zj nj i
сили	s y l y
сирії	s y rj i j i
система	s y s t e m a
системи	s y s t e m y
системою	s y s t e m o j u
ситуації	s y t u a tsj i j i
сказати	s k a z a t y
скандали	s k a n d a l y
скарбник	s k a r b n y k
скарбника	s k a r b n y k a
складі	s k l a dj i
скликання	s k l y k a nj nj a
скоординована	s k o o r d y n o w a n a
скоротився	s k o r o t y w sj a
скорочення	s k o r o tsh e nj nj a
скот	s k o t
скотт	s k o t t
скрипка	s k r y p k a
ску	s k u
скільки	s kj i lj k y
словаччиною	s l o w a tsh tsh y n o j u
служба	s l u zh b a
собаки	s o b a k y
собою	s o b o j u
сотні	s o tj nj i
союзу	s o j u z u
спадщини	s p a d sh tsh y n y
спалаху	s p a l a x u
спарафучіле	s p a r a f u tshj i l e
спеціального	s p e tsj i a lj n o h o
спеціальному	s p e tsj i a lj n o m u
списком	s p y s k o m
сподіваються	s p o dj i w a j u tsj tsj a
сполучені	s p o l u tsh e nj i
спортового	s p o r t o w o h o
способи	s p o s o b y
спостерігалися	s p o s t e rj i h a l y sj a
справ	s p r a w
справах	s p r a w a x
справжню	s p r a w zh nj u
справжня	s p r a w zh nj a
справу	s p r a w u
спричинені	s p r y tsh y n e nj i
спричинили	s p r y tsh y n y l y
спробувати	s p r o b u w a t y
спрямовані	s p rj a m o w a nj i
спрямовують	s p rj a m o w u j u tj
співатиме	sj pj i w a t y m e
співачки	sj pj i w a tsh k y
співдружністю	sj pj i w d r u zh nj i sj tj u
співтовариства	sj pj i w t o w a r y s t w a
співтовариство	sj pj i w t o w a r y s t w o
співіснування	sj pj i wj i s n u w a nj nj a
спільна	sj pj i lj n a
спільного	sj pj i lj n o h o
спільноти	sj pj i lj n o t y
став	s t a w
ставку	s t a w k u
стала	s t a l a
сталося	s t a l o sj a
становлять	s t a n o w lj a tj
стану	s t a n u
старий	s t a r y j
старшого	s t a r sh o h o
старіння	s t a rj i nj nj a
стати	s t a t y
статуту	s t a t u t u
стають	s t a j u tj
стверджувати	s t w e r dzh u w a t y
створення	s t w o r e nj nj a
стефаном	s t e f a n o m
стикаються	s t y k a j u tsj tsj a
стикається	s t y k a j e tsj tsj a
столиці	s t o l y tsj i
століття	s t o lj i tj tj a
стороні	s t o r o nj i
сторінкою	s t o rj i n k o j u
стрес	s t r e s
студентів	s t u d e nj tj i w
студії	s t u dj i j i
субота	s u b o t a
суботнього	s u b o tj nj o h o
суботу	s u b o t u
суверенітет	s u w e r e nj i t e t
суверенітету	s u w e r e nj i t e t u
сумною	s u m n o j u
суму	s u m u
супрун	s u p r u n
суспільна	s u sj pj i lj n a
суспільного	s u sj pj i lj n o h o
суспільства	s u sj pj i lj s t w a
сфери	s f e r y
сфері	s f e rj i
схвалено	s x w a l e n o
сході	s x o dj i
сьогодні	sj o h o dj nj i
сьогоднішньому	sj o h o dj nj i sh nj o m u
сіднею	sj i d n e j u
сім	sj i m
сімоне	sj i m o n e
січня	sj i tsh nj a
та	t a
так	t a k
також	t a k o zh
там	t a m
тампони	t a m p o n y
тамтешнє	t a m t e sh nj e
тарас	t a r a s
тараса	t a r a s a
тварин	t w a r y n
тваринами	t w a r y n a m y
те	t e
театр	t e a t r
телебачення	t e l e b a tsh e nj nj a
телеканалу	t e l e k a n a l u
телерадіокомпанія	t e l e r a dj i o k o m p a nj i j a
телефонного	t e l e f o n n o h o
телефонує	t e l e f o n u j e
тель	t e lj
тенісисткою	t e nj i s y s t k o j u
тепер	t e p e r
терапія	t e r a pj i j a
територіальної	t e r y t o rj i a lj n o j i
територіальну	t e r y t o rj i a lj n u
термін	t e r mj i n
терористичні	t e r o r y s t y tsh nj i
технології	t e x n o l o hj i j i
тижня	t y zh nj a
тими	t y m y
тимошенко	t y m o sh e n k o
тисячу	t y sj a tsh u
тих	t y x
того	t o h o
той	t o j
тому	t o m u
тонни	t o n n y
травмованих	t r a w m o w a n y x
травня	t r a w nj a
травні	t r a w nj i
трагедії	t r a h e dj i j i
трансплантації	t r a n s p l a n t a tsj i j i
третього	t r e tj o h o
третій	t r e tj i j
три	t r y
триденний	t r y d e n n y j
тридцять	t r y dzj tsj a tj
троє	t r o j e
трьох	t rj o x
ту	t u
тур	t u r
турі	t u rj i
тяжкості	tj a zh k o sj tj i
у	u
увагу	u w a h u
увійшла	u wj i j sh l a
угв	u h w
угод	u h o d
угоди	u h o d y
угорщина	u h o r sh tsh y n a
уже	u zh e
украіни	u k r a i n y
україна	u k r a j i n a
україни	u k r a j i n y
україномовна	u k r a j i n o m o w n a
українських	u k r a j i nj sj k y x
українсько	u k r a j i nj sj k o
українського	u k r a j i nj sj k o h o
українською	u k r a j i nj sj k o j u
української	u k r a j i nj sj k o j i
українську	u k r a j i nj sj k u
українські	u k r a j i nj sj kj i
українській	u k r a j i nj sj kj i j
україну	u k r a j i n u
українців	u k r a j i nj tsj i w
україні	u k r a j i nj i
уку	u k u
уляни	u lj a n y
уляною	u lj a n o j u
уникнути	u n y k n u t y
університет	u nj i w e r s y t e t
університету	u nj i w e r s y t e t u
унікальних	u nj i k a lj n y x
урсула	u r s u l a
уряд	u rj a d
урядового	u rj a d o w o h o
урядом	u rj a d o m
уряду	u rj a d u
урядування	u rj a d u w a nj nj a
усі	u sj i
усіх	u sj i x
утрималися	u t r y m a l y sj a
ухвалили	u x w a l y l y
учасників	u tsh a s n y kj i w
участь	u tsh a sj tj
участі	u tsh a sj tj i
фактично	f a k t y tsh n o
фальшивими	f a lj sh y w y m y
фальшиві	f a lj sh y wj i
федеральна	f e d e r a lj n a
федеральний	f e d e r a lj n y j
федеральним	f e d e r a lj n y m
федеральними	f e d e r a lj n y m y
федеральних	f e d e r a lj n y x
федерального	f e d e r a lj n o h o
федеральні	f e d e r a lj nj i
федерацією	f e d e r a tsj i j e j u
феєрверку	f e j e r w e r k u
фонд	f o n d
фонду	f o n d u
форм	f o r m
форуму	f o r u m u
фрайденберґ	f r a j d e n b e r
фрайденберґа	f r a j d e n b e r a
фіджі	fj i tsh zhj i
фізичних	fj i z y tsh n y x
філармонія	fj i l a r m o nj i j a
фіналу	fj i n a l u
фінансовий	fj i n a n s o w y j
фінансового	fj i n a n s o w o h o
фінансову	fj i n a n s o w u
фінансуванні	fj i n a n s u w a nj nj i
фінансуються	fj i n a n s u j u tsj tsj a
фінансів	fj i n a nj sj i w
хоча	x o tsh a
хоче	x o tsh e
хочуть	x o tsh u tj
храмі	x r a mj i
христа	x r y s t a
хто	x t o
це	ts e
центрі	ts e n t rj i
церква	ts e r k w a
церкви	ts e r k w y
цим	ts y m
цими	ts y m y
цифри	ts y f r y
цунамі	ts u n a mj i
цього	tsj o h o
цю	tsj u
ця	tsj a
цілісності	tsj i lj i s n o sj tj i
цілісність	tsj i lj i sj nj i sj tj
цін	tsj i n
ціни	tsj i n y
чайковського	tsh a j k o w sj k o h o
час	tsh a s
частиною	tsh a s t y n o j u
частину	tsh a s t y n u
часто	tsh a s t o
частіше	tsh a sj tj i sh e
чекатиме	tsh e k a t y m e
чергова	tsh e r h o w a
чергового	tsh e r h o w o h o
через	tsh e r e z
четвертої	tsh e t w e r t o j i
чи	tsh y
чинності	tsh y n n o sj tj i
числа	tsh y s l a
число	tsh y s l o
члени	tsh l e n y
членом	tsh l e n o m
членів	tsh l e nj i w
чоловіки	tsh o l o wj i k y
чорна	tsh o r n a
чорного	tsh o r n o h o
чотирма	tsh o t y r m a
шахраями	sh a x r a j a m y
шахраї	sh a x r a j i
швейцарії	sh w e j ts a rj i j i
шкoли	sh k h o l y
школярів	sh k o lj a rj i w
шодо	sh o d o
штатами	sh t a t a m y
штати	sh t a t y
штату	sh t a t u
штрафів	sh t r a f i w
шукачки	sh u k a tsh k y
шукають	sh u k a j u tj
шіккі	shj i k kj i
шістьма	shj i sj tj m a
ще	sh tsh e
що	sh tsh o
щоб	sh tsh o b
щодо	sh tsh o d o
щорічно	sh tsh o rj i tsh n o
щорічного	sh tsh o rj i tsh n o h o
ю	j u
юлія	j u lj i j a
юних	j u n y x
я	j a
язання	j a z a nj nj a
язки	j a z k y
язковим	j a z k o w y m
як	j a k
яка	j a k a
яке	j a k e
який	j a k y j
яким	j a k y m
яком	j a k o m
якому	j a k o m u
які	j a kj i
яна	j a n a
яресько	j a r e sj k o
ятає	j a t a j e
ятеро	j a t e r o
яти	j a t y
ятій	j a tj i j
є	j e
євгенії	j e w h e nj i j i
євробачення	j e w r o b a tsh e nj nj a
єднаний	j e d n a n y j
єднаного	j e d n a n o h o
єднували	j e d n u w a l y
ємною	j e m n o j u
єр	j e r
єри	j e r y
єтнамських	j e t n a m sj k y x
і	i
ідентичність	i d e n t y tsh nj i sj tj
із	i z
ім	i m
імміґрація	i m mj i r a tsj i j a
імунних	i m u n n y x
інвесторів	i n w e s t o rj i w
інвестувати	i n w e s t u w a t y
індонезії	i n d o n e zj i j i
іноземної	i n o z e m n o j i
інтерв	i n t e r w
інтронізація	i n t r o nj i z a tsj i j a
інформує	i n f o r m u j e
інфраструктура	i n f r a s t r u k t u r a
інших	i n sh y x
інші	i n shj i
ініціювала	i nj i tsj i j u w a l a
іоланта	i o l a n t a
історичний	i s t o r y tsh n y j
історії	i s t o rj i j i
іще	i sh tsh e
ї	j i
їх	j i x
їхньою	j i x nj o j u
їхні	j i x nj i
їхнім	j i x nj i m
їхніми	j i x nj i m y
її	j i j i
ґенерал	e n e r a l
ґеноцид	e n o ts y d
ґеноциду	e n o ts y d u
ґладіс	l a dj i s
ґубернатором	u b e r n a t o r o m
